string	string
Hello World!	e lHloWrdlo!	TODO
fgdgoaxmkpzgidgtckaiggzlpupd	gapdkgufdoxkzigcagzppgmgtild	TODO
opucjkynnipxaxrtrizqghrpstnejzmopiispm	pkixihtzimoujynparrzgrsnjmpipcnxtqpeos	TODO
hgceppzu	gphcpzeu	TODO
konkwljeyuh	oluknwjyhke	TODO
wxoscndwfgykkuq	xnguwocdfykqswk	TODO
bvxdhmrkltulkczugwfvyegxevvbjxydykovtqimtimucwzovwlbrekpuvt	vmtcwevxkqiwwevbxhrlukzgfygevjyyotitmczvlrkutdkluvxbdvmuobp	TODO
wxu	xwu	TODO
nrszps	rsnspz	TODO
xphmjorovvgrvpjotphbrygwgwvshx	povppywxxhjrvgvjthrggvhmorobws	TODO
bjgskylepzgpwaryg	jyzabgklpgwrgsepy	TODO
ytjexvlidrodohqmygaevwlywadngfinpobitzwwsjppervgfbimaefmdwwgqhbnbloiggebflwiddxkvnelsgbkrqkzgmhxdzvckshewudpqgupfdbldwxfsf	tvrhgwafozjrbewhlgldngqmzsugdwfyjxldooqyavlwdgipbtwspevfiafdwqbbogefwdxvesbrkghdvkhwdqufbdxseidmeynniwpgmmgnibiklkzxcepplf	TODO
swpbwgxworrvckwdffcrdqsvpmmgjrqpyxzoecxspsltezzjozgoypkecthveofckspouswnjxupporrchgpgdivndleopbyjrbcejilovwvsmu	wgrkfqmrxcszzptossxohddprjvmspwxorcwfcdspmjqyzexplezogykchefkpuwjuprcgginlobjbeiowsubwvdrvgpostjoevconprpveyclv	TODO
fnsegqknfqcufkmatuyszrchxsxpmsscpadixiehxanosperzjyibvufg	nqqkurssaiapjvfsgkfcfmtyzcxxmspdxexnsezybugenuashpcihorif	TODO
vsxfmornzkgvohocfohkgqxbkuxexlilpxqbtduxgkqoyuudsxgthtkdyhezoughwfqluggsnnznvhctxufxeoaoyqkydaerdjgjvggkhdpbxojnhmkzvyse	sokhoqulxdkuxthufgnhuoqajgdomyvxmrzgoofhgxkxxipqtugqyusghkyeogwqugnzvcxfeaykdedgvghpxjhkvsfnvckbelbxodtdzhlsntxoyrjkbnze	TODO
yfskonlgcnwbrmvcdgohbububxqbduxmouwwnhrjnydrxlkai	fnnmguxuuhylysolcwrvdobbbqdxownrndxkikgbchubmwjra	TODO
eustqdgtau	uduesqgatt	TODO
jlkapkadhtrhwwszgkmtsvyeoljq	lktwkvljkpahrwsgmsyojadhzteq	TODO
hjoltipaelrlx	jilhotperxlal	TODO
hpzkpzkapydykliysimlhovebghnsbljirbzvzioacjzp	pzyliogbrzchzpkpdkismhvbhslibviajpkayylenjzoz	TODO
yexarpzpjbdhztvxseavx	epbteyxrzjdzvsaxaphxv	TODO
ylnkoorsnekhvbrwfr	loebrynornkvrfkshw	TODO
fyjamhampacjrjmnhhc	yhajhfjmapcrmhcamjn	TODO
dqgosrawmqfdf	qrqdgsamffowd	TODO
rinkgwhuunkrbqhrtbjvetvyavwxk	iwnqbtvrnghukbhtjevawkkurrvyx	TODO
zcpyjrlmvswkotb	crstzpjlvwobymk	TODO
epuoswgjjcubzn	pwcneusgjuzojb	TODO
itbllqxzixlofvfbbostbacdolsseusgbmsrqpzdqdaen	tqxvoalumpdiblxilffbsbcosesbsqzqanlzobtdsgrde	TODO
purlneqaggdngbkqnibicmkledriboklingjcbuiknrxczoznyzmtgovay	uegbimdonbnzygyprnqgdgknbckerbkigcukrconztoalanqililjixzmv	TODO
fubpqfl	uffbqlp	TODO
xejxyqvzjoggiwh	eqowxjyvjgihxzg	TODO
snfohsprcsjfecgzdcnalpunkvflztn	nssccpvtsfhpcjegdnlukfznorfzanl	TODO
dfow	fdow	TODO
wnewxathbufqobtyixqfdqvlddmyxqtdijhlqxnhtjqkmlxyiqjheoyeymsxintrktfwyqiosrlrnfcxrmlirz	naubxqdqjxjlqomntqrfmzwextbfotiqdvdmxtihqntqmxijeyysitkfyislncrlrwhqyflydlhkyhexrworxi	TODO
sfoqilbvcdchanmjkahvzfhy	fldnafsoibccamkhzhqvhjvy	TODO
olofvuveqddwuoxgyfcgcgyytupwkpthsddcndwtjyaekufnkvdlbjonqehrzyepeuokwmpyzbeirtvjfjimgduupnilltwukgoaorwmpkuprjakbxnuonolitroo	ludofgupddyuvjeyumbtjdntgrkjxntoovvqduxyccytpktsdnwjakfkdboqhzeeowpzervfigupilwkoowpurabnooirofewggywhctenlnrpkyijmuluampkulo	TODO
uqesqfbeajndpujzaulranmbbnoljknkbhc	qfjuunnkhueqbanpjalambojnbcsedzrblk	TODO
ofvtj	fovjt	TODO
jtseanneeczwgve	tncvjsanezgeeew	TODO
alfpfubsmvyukxjcfarzwgebp	luvxagaffbmykjfrweppsuczb	TODO
cag	acg	TODO
xsysioaouzemy	sozxyiaueysom	TODO
rgofgvnjzpsycwkiydjjdsjdmxpie	gvpwdsxrognzsckyjdjmpefjyijdi	TODO
jttdiejwksdxelyolldraqowjhhbioitnvfeldgcymmsrtgypwtfuwelif	tesllqhovdmtwwfjtijkdeyldaojhiinflgymrgptueidwxorwbtecsyfl	TODO
lvzgjtjrd	vtlzjjdgr	TODO
nwbafnytpqa	wnqnbfypaat	TODO
mhs	hms	TODO
cmswu	mcsuw	TODO
ojfbgxsibhaykxbbydy	jxhxdofgsbakbyybiyb	TODO
call	acll	TODO
socieusiecpzcbjcgnnsijcaucvlltqwofpyfohhqdhfbamkffheyunoasdrpbgdomyrudrwdtwmvobunvzdbz	oucbnjctfodafusbmdtovzscesepcjgnicuvlqopfhqhbmfhynadpgoyurdwvbnzbiizcsalwyhfkeordrwmud	TODO
gji	jgi	TODO
cdlgdag	dacldgg	TODO
quajrblup	ubqarlpju	TODO
fjhfmatjd	jafhmtdfj	TODO
ibcxt	bictx	TODO
ehaxovdrysixnfhhncaryijhzzpemianpzavurauqlwayguxlypjyocbgkwtohtziymbdxbxmseikwitzrwnjscaxjrueqd	hvsfcizizrlgyokhyxswrsjqeaodyinhnayjzpmapauaqwyulpycgwotimdbmekizwjcxredxrxhrhenvuaxjbtzbxitnau	TODO
yttkbsnxelfivllenwpyueqvbkvjsgyecdecpwxjqqvvxddmojlxtodeimkbjymrugmtetoazxoqm	tsllwekgdwqdjomygtxytbnefvlnpuqbvsycepxqvxdoltdikjmumeozomkxieyvjecjvmxebrtaq	TODO
cljjubdncqibloqirprwaneryzoeapf	lbqopnzpcjudcilqrraeyoafjnbiwre	TODO
exnogcjqjlhllumavvufezx	xcluvzengjjhlmvuexoqlaf	TODO
ojcskysypritbjmcmqakcsypovrontyr	jyrjqsvtockspibmmacyornysytckpor	TODO
sdffu	dsfuf	TODO
qljiqnmdkclaynbhbrtqurzggcfkekphve	lncnrrckeqjqmklybbtuzgfepvidahqgkh	TODO
emoedpahufpmmuprdlpnnsdkqivadwwjsubnfqrbidsjieischhlaeuvdbqilawpgskqyu	mpfulsiwuqdehebasueodaupmpdpndqvdwsbfrisiichaudqlwgkyehmrnkajnbjslvipq	TODO
pmhsaqayeurihgplpcziklrlqzqavfirnajbfmquudzwva	mqugclzfamdaphaaerhppzkrqqvinjfquzvsyililarbuw	TODO
bnlwikbspbrbft	nkbtblibprfwsb	TODO
sqqhwoxjbysywunpbogwytiwj	qoyuotsqwxbswnbgyijhjypww	TODO
zzwhghqxpwhh	zhwzwgqphhxh	TODO
yvw	vyw	TODO
sxidektkoxcitrsdzmirnomzmdebeyvtljfybcnbfmuporvbmwdbjdndauinnlvrfonaggyoo	xkxrmodyjcmrwdulogsietoctszinmmeevlfbnfuovmdjnainvfngyodkidrzbtybpbbdnrao	TODO
oppneat	paopetn	TODO
yhwrvc	hcywvr	TODO
phduremmfzvxpm	hezmpdrmfvpumx	TODO
jwabxtxzujtuzwenfnfysohvmgjkyutfhurposmaoexbgcecxlnjfhtrimcivsctjyomnumvuitut	wtjwnoguuseclhmsyuijaxxutzeffshmjythromoxgexnfticvcjonmuttbzunyvkfpabcjritmvu	TODO
lhrfmngdcum	hnulrmgcmfd	TODO
bnnvve	nebnvv	TODO
lyhgernzvxzztomuuvuunzpaepe	yrxovzplhenvztmuunpeegzzuua	TODO
cmbdoyafbcozmsibwlijkzeoxvej	mycslzvcboabomiwikexedfzbjoj	TODO
ofktxqsbjwzchqsqrvoqmnytzcgadnvpsnjqagmqjesuuuryqrchdwazbyojhkvguklmibogrmhpgjhqwjerdviunvthtkfoyp	fqwqvncnngeurwykkbmjjvvkpokxsjzhsromyzgdvsjamjsurqcdabohvuliorhghwedinttfytbcqqtapqquyhzjgmgpqruho	TODO
gikexhvdlggqqetpckypjdopiyeyrdsecuopvgyleyuik	ihgekdydugygkxvlgqtcyjoierscovyeukedqpppyepli	TODO
ruttkmxesoe	umortkxsete	TODO
vthddifyhkfhdzwtui	tikzivhdfhfdwudyht	TODO
wftwmd	fdwtmw	TODO
zepvki	eizpkv	TODO
mvupjkalnltvrd	vkldmujantrplv	TODO
wddo	dwdo	TODO
kjkvewasyarbdeegtypbe	jwaeykkeayrdetpevsbgb	TODO
wjpukgxclbdchjctmdfrjlpst	jgbjdlwpkxldhcmfjptucctrs	TODO
xby	bxy	TODO
moftgiaxofjwwswjyqfocdfdepjeezzhqczqsxmkggkfmsfnjnmpovxtjxjsynuweukjxhqvpfrfpbfwvzsdqszfciidnazsske	oifsqdpzcxgsnvxnuhfbzsiakmfgaojwwyfcfejezqzsmgkmfjmoxjjyuekxqprpfvsqzcinzsetxwjodehqkfnptswjvfwdfds	TODO
ltpwlasxklfrclgzekoztyienevglzdhqqwdh	tallkyezqlplskfcgeotinvldqwhwxrzzeghd	TODO
mrkxirzttilpsupsgmmeaauhqhmimjwzvfxbewmydywyuagynnyihf	rriumahjfwyanfmkiztlspgmauqmmwvxemdwugnyhxtpsehizbyyyi	TODO
mft	fmt	TODO
vvcbeaoba	vavceoabb	TODO
waqy	awqy	TODO
qlbgfgfslqkhzpegyabhwempwwgwaingioskziekjnyrtnqglddxqzbkb	lgqpaewioinndzqbfflkzeybwmwganiszejytqldqbbgshghpwgkkrgxk	TODO
jmjyahbvneiqpeutfob	mheeojjabnipufbyvqt	TODO
pfktps	fspkpt	TODO
pab	apb	TODO
wyeslmhracpidmsxdfennuyizufritcntivkmifuiedlfjdncfxgkfrnryglwocyaenvwcwwtnezboatenbakllnibghieixhvgnbblmrewrmngf	ymcmfuutiiejffyoecnonlbevbenwelhapdsdenyzfictvmfidfdcxkrrgwcanwwtebaebkligiihgblrwmgsrixnirnkulngnlyvwztanhxnmrf	TODO
xkqzdqcjnfwruvlyyjxsyvh	kqfvjvxqdcnwulyxyhzjrys	TODO
vtn	tvn	TODO
xwxqsbxjusikzxbjnfwoqpvdpjcjdjxuhdyylexjh	wbsxfpjjdexxsxuizbnwqvpcdxhylxhqjkjodjuyj	TODO
brofqaxxbcbmflxrtpxnpkrqomkzuplcbmjdnun	raclpkmpmuboqxbbfxtxprokulbjnnfxmrnqzcd	TODO
uqp	qup	TODO
ivswyedmltuxyrnxnfquokdctvxmuffcukbzpnvvbvgzurwhmtwchryyxt	vetrfkvfknvrtrtisydluynnqodtxufubpvbguwmwhyxwmxxucmczvzhcy	TODO
uuqpddbwdsizvtwphejuhmkyvfcrhfuegnbcesaqxrrdmylrjbcqfxgqmueamcvxquyqbcvj	udstemffnsrybxucucuqdbdivwhjhkvchugbeaxrmljcfgmemvqybvpwzpuyrecqdrqqaxqj	TODO
xcb	cxb	TODO
emiucwkcofvzqduvwkmatlijhqwvudmqtlgdwjgzvwgghneodtfzswpznzkdofnoubldxdcdq	mwfdklqdljwntwzfbdeickovquwmtihwumtgwgvghedfspnkonulxcquczvajvqdzgozzdodd	TODO
mptnwexjysdktytgkdhowkhkohilbw	pesydkhwmtwxydttkhwhoibnjkgokl	TODO
mzo	zmo	TODO
dbww	bdww	TODO
dewhzeiodrvdbhpjkbibaoioul	eerhboldwzidvbpkiaiuhodjbo	TODO
spkvmgdkkpqzh	pgpskmdkqhvkz	TODO
atylbb	tbaybl	TODO
jhdoi	hjdio	TODO
thl	htl	TODO
uzretk	zkurte	TODO
nefazypiu	eynfzpuai	TODO
ppnrrmelkc	pmcpnrekrl	TODO
kycqjwiftqnkb	ywqkcjitnbqfk	TODO
bbuegymp	bybugmep	TODO
jvktwzkxhoij	vzojkwkhitxj	TODO
ohxjscnpxzvfnlobxyrzdwqwkdbigro	hczlywdroxsnxvnoxrdqkbgojpfbzwi	TODO
srzcisialygqzoggvbojroavuvz	rsyobovsziilgzgvorauzcaqgjv	TODO
dxiqooe	xodioeq	TODO
jqgv	qjgv	TODO
ttt	ttt	TODO
cmaqzhlvmsdpmvmkgksqfgylalbednvkngllpdhqxmtelhhzfezunwlolgbciwyfehyivjnxjqujdccwvvzollmiqj	mhsvkglngdmhewgwhjqcvljcazlmdmmgsfyabdvnlphxtlhfznllbiyeyvnjudcvzlmqqvpkqleklqezuocfixjwoi	TODO
socmr	oscrm	TODO
nmqyddjbxflbrvxjwwpnlwadmngjsbcxdgyqchcuogkhrkrgzccpzhqzuuqbmuouerrlcsloqjndbentvdhnisiuoyyipsjejuuivqnvmrtpkwhilzxmgn	mdfvwwnbghgkchuursjedsysuqrwznnqdjxlrxwplamgscdyccokrrzczquqmoerclqnbnvhiioypjjuvnmtkhlxgybbjndjxquhgpzbulodtnuieivpim	TODO
ooselc	ocosle	TODO
neiugmsfltysxo	emtonigslyxufs	TODO
iqjcblht	qlijbhct	TODO
pheu	hpeu	TODO
trgnajacrnkwofzpocctlonj	rjnfcotgaarkozoclnncwptj	TODO
ieqqkcgyyr	ecriqkgyqy	TODO
ubzjkbuifsndmbqycbadkjxfwpzvibyugemsbbbxgkpopcozhaiiziaj	bbsbbjpbebkcaiuzkufnmqcakxwziygmbbgppohizajidydfvusxozij	TODO
ptyzfaa	tapyfaz	TODO
ywyqxxxookhlpccamsvymzrvtmphfveakeclsmsznfriaulzpxritwvlbxrwngeagfxhgmgccbfhekacinwlrdasj	wxkcszmvemfuxwxgfmbkndyyxxohpcmvmrtpfekcssnralprtvbrnegxggcfeaiwrajqolayvhalzizilwahchcls	TODO
mdqputnnqyozf	dtymqunqofpnz	TODO
rkr	krr	TODO
oxmkyrxvcycyixnklytrdlrrcvemsqazanwdttzexmazhxvjlmugodtnmkepkjqnzwqlfzrnsfoikntlvjwfeacreunahdumfykixerhkpwtxtooitkbu	xryxylvqntmxmdkjwzfnjaudyepttomyxccinltdrcesaawtzxahvluotmekqzqfrsoktvwecenhufkxrkwxoikukvykrrmzdezjgnpnlnilframihtob	TODO
bkbpsmqtpelg	kmebbsqplptg	TODO
kspwxpbjvqerecbuzmvzo	spqcmkpxbveebzvowjruz	TODO
dznuhwjfqzo	zwzdnhjqouf	TODO
wuyulrt	urwyltu	TODO
dot	odt	TODO
piunhy	iypuhn	TODO
nbcsghcr	bhncgcsr	TODO
dwac	wdac	TODO
ksocbkmckdssm	skdkobmksmccs	TODO
bkybfvtdd	kvbyftdbd	TODO
pvrrtlogtl	vllprtotrg	TODO
kdgzgqo	dqkggoz	TODO
ujilxjkrkycxexxtwynldugpaompedu	jjyxyuoduixkkcexwndgameulrxtlpp	TODO
vcjlfvcyjo	cvovjfcjly	TODO
keb	ekb	TODO
rhuqjtvpmijyoyropjyjklweveaiubnyevztzmlpnzglgslmmcgmuswymiyhwqxivelxmylktxcdkwubieboptwbwmlqedguwfpvitcsyfm	htiyjlebvmzscsiqeyxwetmdftfrujvmjorpykwvaunezzlngglmguwmywxvlmltckuibpwwlegwpicymqpyojeiytplmmyhixkdbobquvs	TODO
rhnbfbfqyzoej	hbzrnffyojbqe	TODO
oclc	colc	TODO
xsirkybgqewmad	syedxikbqwargm	TODO
nzirhwryjwspdymdfgwfcdavuo	zwwygdonihrjsdmfwcaurypdfv	TODO
cuwyj	ucwjy	TODO
wsdnnfb	sfwdnbn	TODO
vbufdv	bvvudf	TODO
whwdqnvxuxorsrazkhvjghncxvzzmbwztdqmscggvyngspcprylqtpovfymyaiiytdzphgflcypzrgqhxckhkbuuyaramxqgadwjfylqfsmjlsdptin	hnxrhhvbdcypypyidgygcbaxdyssiwwqvuosakvgnxzmwtqsgvnscrltofmaitzhfcprqxkkuyrmqawflfmldtndxrzjczzmggpqvyyplzhhuagjqjp	TODO
uezrlsnkgmhzbawwgjqcyadcnigxjwzxrlkqcvhtoxlcpkkxzzu	esmajaiwlvxkzuzlnghbwgqydngjzrkcholpkzurkzwccxxqtcx	TODO
ijznlkmjazaurdnrobirbwobglph	jkzdbwlizlmaarnoibogpnjurrbh	TODO
sbxpsnjl	bnsxsjpl	TODO
dgbfdpfagqgtfrwvmdvdtqhxrjsjcnykmpxraxnsjtkwhchlmtbmrwavr	gpqrdqjnpxtctwdbdfggfwmvthrscymxanjkhhmbrarfatvdxjkrswlmv	TODO
hpqeuhgjklwsulzmswcfr	phllwhqugkwuzscrejsmf	TODO
odcefgr	dgocfre	TODO
cxrrzhlsj	xhcrzljrs	TODO
rintbqy	iqrnbyt	TODO
hkcnvdkqe	kdhcvkenq	TODO
rfkqjzfwrpfwoikorxmokfldvocswzqdcgptqnfdzjlcdrd	fzpixfozgnjrrkjfrfokrmklvcwqcpqfzlddqwwoodsdtdc	TODO
nuvuuwvho	uwnvuvouh	TODO
vizqtopzsqufnp	ioqpvztpsunqzf	TODO
lijfdiuhtxeshyeehvulzfuidarxwgmkgvheguqyosmwquqmrimpgtbayhlxzmhoipmqcppnfbxzxrjjaluehx	iixyvfagvusuithmppbrlxljdutehehuzudrwmghgqomqqrmgbylzhimcpfxxjauhfhselixkeywmpaxoqnzje	TODO
nyl	ynl	TODO
csauwujtdgwwniqesfgeyqdxingjqwafhispsbkimcfswowgzrrpdwhizludxbiz	sugifqnwibcorwlbcawjdwnqsgydigqahsskmfwwzrdhzuxiutweexjfpisgpidz	TODO
qyhzc	yqhcz	TODO
enjeqvkkammsbttcjwvwpzgxoyrkriqkgjynrwugxwcktkwibabeurmyhmxxxfz	nvmtwzyijwwkarmfejqkambtjvpgorrqgyruxctwbbumhxxzekscwxkkngkieyx	TODO
xuzrq	uxzqr	TODO
bvxu	vbxu	TODO
didxkckvtugihwggee	icuweddkktghgexvig	TODO
duha	udha	TODO
crpswalchhdhsvjkxkmrkwdwobkrkveucyadpsy	rahvkwbvyscpwlhdsjxmkdokkecapyschkrwrud	TODO
ndbxcdlvwaotlhabqlojgw	ddahlwnbclwolaqogxvtbj	TODO
xsqucwsr	swxqcsur	TODO
mxuexhw	xhmuxwe	TODO
aukmnuhvnbtaog	uubgaknhntomva	TODO
spstsbw	pbssswt	TODO
dzumrropqsdwju	zrsuduroqdjmpw	TODO
hwcyuclwknv	wcnhculkvyw	TODO
rxbfgn	xnrbgf	TODO
esgjutympii	stieguypijm	TODO
dxfyawxdagj	xwgdfaxajyd	TODO
ciqsmnfuumzwjdzfnmrugveriyvndymfxleepahkhfccokxxjmzkzlvhmhtpiznemcrhodvoqepndviztkafrricpuwlrphoosytgcjpgujshpprevwsnmcy	inmdmvyylafkmlhzcdevkrupscupvmcqmfuzjznrgeivdmxephhcoxjzzvmtinmrovqpditaripwrhoygjgjhpewncsuwfurnfekcxkhpehonzfclotpsrsy	TODO
qwkgitkpcehoxkpzfuqgzs	wtekusqkikchxpfqzgpozg	TODO
asxwfiyzpiwnttuvydxumwrroepljxeqwpgugshpheuqclhtpfvn	siitdwexpselfaxfypwtuyxmropjewgghhuchpvwznvurlqupqtn	TODO
qyycecaclslggdhrbqfbyncashdc	ycsdqnhqyeallghbfycsdccgrbac	TODO
fffujt	ftffju	TODO
tbjrbchodehmhuvwxeoltmefnwoqnecufzxnzpsliidcudxmfrblor	bceuemwezpidrrtjbhdhhvxotenoncfxzsiduxfboromwlfqunlcml	TODO
pmdesczfmefduubdvbcoaalqubelpqnmyvxzoqmiurfudxmsonramwygfyjb	mceubabqvqrxnwypdszmfubvcaluepnyxomufdmormyfjefddoqlmziusagb	TODO
mpzwsiwkrlvxbngffffbpwbdhhyxjlos	pilnfwhlmzswrvbgffpbhyjowkxfbdxs	TODO
adrysbyhaazkvvcmkodwzofbddgvcdbwafqvvroaictzumcmopckfdvqxbpbkd	dbavooddfrcmpdbdarsyazvckdzfdgcbaqvoitucocfvxpkyhkmwbvwvazmkqb	TODO
bvrlqjqrlyspxrpmaarulkvschg	vjyrakhbrqqlsxparlvcglrpmus	TODO
yabqsmoncbk	ambybsockqn	TODO
rrwljk	rkrwjl	TODO
rbubqixygkhsvdlggrmzuctzfkkppzpnksju	bikdrckzsruqxghvlgmutfkppkjbysgzzpnu	TODO
pbjsrpzetkyopuljuruoq	bpkurpjrztypluuqseojo	TODO
tczn	ctzn	TODO
wdte	dwte	TODO
cauhf	acufh	TODO
zkcmbqxvtakyzistdidwdrrifutuvoufyrxsoohuegjklnirtdnkrcxotqskqkyquymsperuucl	kqaiiruorogndcqkyeczcbxtkzsdddrftvuyxohejlitnrxtsqyumprulmvytwiufsukrkokqsu	TODO
phqpx	hpqxp	TODO
bzjylzcdixiog	zzxbjlciigydo	TODO
kuxklgzlnqvhwrwijliqefzdysyywhgvhlbse	ugqrlfshlkxlznvwwjiezyywghbeklhiqdyvs	TODO
iehrlpuvxhrrfccqqtuvevdemjooxnjymeuxea	ephctvjneaihluxrfcquedmoxjmuervrqveoyx	TODO
sgfljfkwycpzpfvymnoufsjpxcgsaswgfujintiwoevmbghgsvvcgrcxtgpb	gfcfnscsutegvrgsfjkyppvmofjxgawfjniovbhsvgctplwzyupsgiwmgcxb	TODO
avo	vao	TODO
jlofzpvoxikashkhboczrpbkfoxkrxgmjsevlqbwjftjmvcatfngvzyhydkdhfrnjrqysfuofvkfqgnhosppioes	lpihopoxsqfvfzdfrfvgsojozvxkskbcrbfxrgjelbjtmctnvyykhrjqsufkqnopiefoahzkkmvwjaghdnyofhps	TODO
pkdyp	kpdpy	TODO
yyzg	yyzg	TODO
ucik	cuik	TODO
dsdqvrsykpytespzkitaldupvfkfzpjblbatveaoyamgzyvdoqfxqkssydsfwlaqqqhwusoqihxeil	srpsidfpbeayqkdlqshlddvskyepktluvkzjlavaymzvofqsyswaqhuoixiqytzapfbtogdxsfqwqe	TODO
tqemhtdcouhdmsciddcewqsuzoobqxtfliucillyaxifgmmgwcvzenpc	qtusdqoxilxmcntehdohmcdcwszoqtluilaigmwvepmcdieubfcyfgzc	TODO
trg	rtg	TODO
njk	jnk	TODO
otyayhxxsjsyfhckoelaywigxnalthmwmbdxxsphbyva	thjhewnhbsyoyyxssfcolyixatmmdxpbvaxykaglwxha	TODO
vjqaddb	jdvqdba	TODO
lgjqlliynqlliwxrbuqxd	glqwuljlinlixbqdqylrx	TODO
aupgzjglfzooopklacerznlzroedbiaubyytzkibeataljyrpirkwwflwvasygblcyzggrjbblovmklqk	ujzpcnoiykajiwvgyrlkapzgfookaezlrebabyzietlyprwfwaybczgjbomlkglolrzdutbarklslgbvq	TODO
inuxlltdahmqpekzqh	nlhehiultampkqxdqz	TODO
errqqrfepcdoqanbklzsmritaihwowuabjhimqjcbpjzlqhcokapgzujte	rrcalriwjqpqkzeerqfpdqnkzmiahoubhmjbjlhoagutqeobstwaiczcpj	TODO
xjugjqkas	jqxujksga	TODO
esfjuqynmlrfeuzcnfhfnqlzx	sqlufqefuymreznhnlxjnfcfz	TODO
ozuspzxqtcsighmqsncezfwigvzpdpwsfxlzshawicyxunyurvjvmxvjdfrylaqrivrkgbricvbvsjjmpxcfpslsbwk	zzchnfvpxhcnvxfavbvjxswoupxtsgmsczwgzdwflsaiyuyrjmvdrlqirgrcbsjpcplbksqiqeipszwxuvjyrkivmfs	TODO
okrfsfdyrx	kfxorsdrfy	TODO
vcnlvvikgayvtlg	cvalvnvigytglkv	TODO
ldyeal	dllyae	TODO
kgwmxfwgkfx	gffkwxwkxmg	TODO
uyoknnyjp	ynuonypkj	TODO
tczgswwlaonrphxkkzjzjohzhsqqtgbzxehoyfprjpbacunkywajybwdgpglqlhaogznhkyhsdaphkxefsemrnnlfrvwsdhnoejtoqhrsxdbebhrnycmibswgh	cwohzosgefpuwbplgkdksnrdeqxbybhtzswanpxkjjhhqtbxhypjbcnyaywggqhozhysahxfernfvshojohsdehncisgglrkzzqzorakjdlanhpemlwntrbrmw	TODO
irkyvueghjueibhgbrfyhugqgk	rujbrukikvehuihbfhggygegyq	TODO
ypcwksku	psyckkwu	TODO
vfzzcvyrzkcdfu	fvkuvzcyzcfzrd	TODO
luxmcjlqkkuvetyxsukcosxrmarl	ujktusalxclkueyskoxmrmqvxcrl	TODO
iiozk	iiokz	TODO
czttmhbtyvqmrcupyftla	zhvcfctmbyqruytattmpl	TODO
jnfypdnaboiob	ndojfpnbibyao	TODO
hibatjg	ijhbtga	TODO
tnvioznurlkwawryfyiuvzlxldyv	nzlwyzdtvonrkarfivllyiuwyuxv	TODO
uuiw	uuiw	TODO
ritwywbcxzphpidupeozzhvnrsstrkvarvfgiirhldxzsfmydgxktimyjn	iwziehskvidfginrtybxppdpozvrsrvrfirlxsmdxtmjwchuzntaghzyky	TODO
sjomcbnrjmagqnktaic	jbmnisocnjaqkacmrgt	TODO
fggotfufsabx	gfafgtusbofx	TODO
fmaiiphqyobjxwxdczgaxjzaixzlxicwajqegdsmfhwzzkee	mpowzjxijdhkfaihybxxcgxzizxcaqgsfwzeiqjdaalwemze	TODO
sqcvcdw	qdsccwv	TODO
hvvsdbsidaxstmgakieqbkcze	vbamikhvdsdxtgkebcesisaqz	TODO
rcuhrrhlphuonrwzkkcbiqwrdzqpzuyqhissneohyqkwafjbaptwjv	crhrkqzuieqfpvrurhpunwkciwdqzyhsnoykajatjhlozbrpqshwbw	TODO
iwuurf	wfiuru	TODO
fdtlvadajsmhocg	dascftvdjmoglah	TODO
kfdyjlemccueiswcyumx	flcsukdjecuiwymymecx	TODO
iroi	rioi	TODO
iqswypbvtngjgyylrbdajqufebiucuvocwnwrdph	qpnybqbuwdisybtggyrdjueicvcnrpwvjlafuowh	TODO
xkojoqjoutyqlhahzbkt	kqthbxoojuylazkjoqht	TODO
hgqmbgqo	gghqbqmo	TODO
dwmttbqzulaetexuzxxifsqwafimpyuzeeqawrqcsnlwgmdoeo	wblexsfyernmodmtquatxzxfqaipueqwqslgdetzeuiwmzacwo	TODO
xqdxtyasysulvynwixhcakyhkqbhonbkywhtdhoyyfzaegetrdtxcalnmvmw	qysyxkqnwhfgdavxdtayuvnihaykbobyhdoyzeertclmmxslwchhktyatxnw	TODO
xbrkaitosbdwkjtjthpfpizjydxfjkmgdtdhqfmfkqvudscmf	bibjhidktfqsxratsdkttppzyxjmddqmkvdcfkowjfjfghfum	TODO
goa	oga	TODO
ddykvnlkmwpjguouzmbzzgskxpvjhyidpmw	dnwumgpymdyvlmpgozbzsxvhipwkkjuzkjd	TODO
tprixthylwbmiqumwsbdjxcnewywhzgocguhgyvpjrpsrjetbo	ptwqsxwzgyrjotrxhlbiuwbjceyhgcugvjprebiymmdnwohpst	TODO
fmvikbbxiwkwsglsvjpbwgmfipadhswlaxlmjsoszvxaemftkcxvqoziwq	mbwgjgpsxsvmcoqfvkbikslvpwmiahwaljozxefkxqzwixwsbfdlmsatvi	TODO
aenmnpdattzmiiqjtvyaejaonbctaoodpgbvoyjursfxtgusxptbnvsu	eptivjbogysgpvanndtziqtyeancaopbojrftuxtnsmamjaotdvuxsbu	TODO
cwhxtboitzmtlnpdczlvvbmjgqfomkcnqnudqqdkbgfqhngixjtwlcrjopahnh	wbznzbqknqgnjcphchtotmlpclvmgfmcquqdbfhgxtlroanxitdvjondkqiwjh	TODO
xuiarjr	ujxirra	TODO
wkozyvaua	kvwoyaazu	TODO
rbwrve	berwvr	TODO
ycjjwcwsrqdyvomnumwjyupeavanm	ccqomuvyjwwrdvmuwypaamjsynjen	TODO
oufzmhxze	uhofmxezz	TODO
wkxfttsqltqpbw	kttwwxtslqbfqp	TODO
pvxhmb	vbpxmh	TODO
zdakpqlnnbfdqsujvoot	dqbsozaplnfquvokndjt	TODO
rtxlslsbofascvgcdzossjkhetqcjskndbyi	tlfvzjtsbrxssoacgdoskeqjkdylbscshcni	TODO
whgnnwwlqdvzx	hwdwgnwqvxnlz	TODO
ynw	nyw	TODO
lpxzrij	pilxrjz	TODO
kxgpubjhhioljczqwoqpmvadmughnetquqvcovflcxgnufay	xbicovueqvxfkgujhojzwqmamgntuvofcguaphlqpdhqclny	TODO
skk	ksk	TODO
dwdnqsjewvpvesyrogqaz	wsvsgddqjwpeyoqznevra	TODO
sgtk	gstk	TODO
znvlgawy	nazvgwly	TODO
clvzku	lucvkz	TODO
rnxyzdwtga	ndarxzwgyt	TODO
yndrtv	nvydtr	TODO
rmxmyeprqmhtevfcjeob	memverxypqhefjomrtcb	TODO
tdeeqgkrradckumbvlgqn	dgaulteqkrdkmvgnercbq	TODO
jvzpbzabchwbvyp	vzhyjzbacwvppbb	TODO
xnnkiuht	nuxnihkt	TODO
oamsumggnxeknaxraizmammzcchtccgswxysgnghhvllgsqxfbnwknzbmr	amxaimccxnvsbnromugnenxazamchcgwygghlgqfnkzmsgkrmztsshlxwb	TODO
hchniyyfcbgnwymvilgemkvblqmxirzsiqnkdzlqtypjgnjjbmotfwfpslksnpjzqztdwzxljlydzfvaxqrawppfv	cybylkqrqzynmwlpzzlfqphhiycgwmigmvlmizindltpgjboffsknjqtwxjyzvxrwpvnfnvebxskqjjtpszdldaaf	TODO
dtjxhjy	tjdjhyx	TODO
iascdmr	amisdrc	TODO
pojsdawjvakttthhrmagpfntf	oaatmfpjdwvkthrapnfsjthgt	TODO
xxzgpnjfzpsrqrvaauxfqdemluqducmseckpxmmmkfd	xnpruduccmfxzpjzsqvaxqelqumekxmkdgfrafmdspm	TODO
dsxiwocczkmarzkaylmhmikafgetxcztrmgxstaylhonnchlxvmbooxndpsiqyuzryhr	sokzligcmthcvopyydxwczmrkymmkfexzrgsalonhxmoxdsqurhicaahattxynlbnizr	TODO
akktyhl	khakylt	TODO
hrxbpqsehuip	rquhxpshibep	TODO
ihr	hir	TODO
mxligbwispxayosqvabqypntdeejaq	xbpoapeqmlgwsxysvbyndeaiiaqqtj	TODO
zrppxcexdrotjphuqpylrl	rcrpplzpxedojhqyrpxtul	TODO
xzngdi	zixndg	TODO
phonoh	hhpoon	TODO
srjgzsyszuzdjmsnzwckemqxpxhqodfgrkqzncfbh	rsumwmxdkcsjzyzzjszceqphofrqnfhgsdnkxqgzb	TODO
hkg	khg	TODO
hfb	fhb	TODO
ltqaaqvikliclqgknrfbsloxtzotnsscobgfwyzwtssqdeonvcuvlfpjwuujsecoc	tqlqrlzsbysecfuelqavkilgnfsotonsogwztsdovulpwusccaickbxtcfwqnvjjo	TODO
huogvfothaa	ufahovohagt	TODO
xoowthvxo	ohxotvowx	TODO
aoaebuduxhrwglitshwccxzgjpifhjabhvsplokmughbo	ouhlhxpjvogaabdxrgiswczjihahslkuhoeuwtcgfbpmb	TODO
xajjonfkttysdi	antixjoftydjks	TODO
qgjonntgyxpdwgciogjcocohipewrgvfvygbddnj	gnxggcpgydqjntypwcojooiervvgdnogdichwfbj	TODO
enifzkpj	nkeizpfj	TODO
gycgbmuglrfyqsfdwr	ymrsrgcbulfqfwggyd	TODO
cqfeshr	qhcfsre	TODO
lpjiudzyvtbawjvldozar	pdtjoljuzvbwvdzriyala	TODO
vsywaqixegclvczqz	sqgcvyaiecvzzwxlq	TODO
scxxucunkzn	cczsxuuknxn	TODO
detvksztejgnaociggicpwl	esjogwdtkzegacgiplvtnic	TODO
kkktovrjpw	kvwkkorptj	TODO
jgyoib	gbjyio	TODO
gsgz	sggz	TODO
cdbrobbntddcjxfucdfgsonwysrowxuonphhodfsrnqjxvsrmzvzaqfbicsvbffczmwqwxdbrvogvkjd	dbdxdosxpdnvzqcfmxvkcbobtdjfcfsnyrwunhofrqxsmvafisbfzwwdrovjrncugwoohsjrzbvcqbgd	TODO
pffmmifhkibhhb	fiibpfmfkbhmhh	TODO
ypbolwsagdedlwylsfklbqrauvbk	pwdwfqvyblsgelyskbruboadllak	TODO
dnemjy	nydejm	TODO
clstiodkgub	loucsidgbtk	TODO
wwbwmsuccbopwmrkpierfcvs	wsbmicwbmucowrpefvwcpkrs	TODO
xivgutpsmgoikm	itgmxvupmokgsi	TODO
enpvpwimxsbntegerdapddhraojxekqvchmnimqnwpim	nwseddokhmpeppixbtgradhajeqcmiqwivmneprxvnnm	TODO
czllxc	zcclxl	TODO
cfcjmocscbhtcfsmuuhrkusnichmts	fobfuucsccmcchcsuhksihtjstmrnm	TODO
vydrufredcszhvyvgoioprrfywrsja	yfcvorwavdurdshygipryrjrezvofs	TODO
spwkavgdqakn	pvaswagqkkdn	TODO
vnkpgufhmlgvyhigbanovu	nulhauvkgfmgyibnvphvgo	TODO
epnmnjfeychwpg	pjcgennfyhpmew	TODO
fgnmlkwrfwhc	gkwfnlwfhmrc	TODO
cvqyliomovnrjjvgliwnbluvaokjcpflarzpkrfcqfqmczbgvktzttzfybhvyjythrsageqmlfyixzbcjltnhor	vivjiloprrfzktbjrefzlocqloonjvlwbuakcfazkfqqcbvttzyhyyhsgqlyxbjthrymrgnvjlpcmgzfvtamicn	TODO
oojogs	osojgo	TODO
pefp	epfp	TODO
sfjgwmrsxigkqp	fmipsjwrxgqgsk	TODO
ckzwkwrovyhpoamfrs	kwyasczkrvhomrwopf	TODO
uoisgdjutbxrttaczgvhbdlqmafhapdrotbnkybeu	odbtgdaptyuigjtxtazvblmfadobkbusurchqhrne	TODO
vyhnkn	ynvhkn	TODO
tvyyvxvcrwelnnatmbpqcafef	vxwnbatyvvrenampcffycltqe	TODO
krlwc	rklcw	TODO
vfolxvhwn	fvvoxhnlw	TODO
hnxnh	nhxhn	TODO
gjnpxmayrpiqmysbumfleuvhro	jmpymuognxarimsufevrpyqblh	TODO
djq	jdq	TODO
jvnvro	vojnrv	TODO
hlnagkcezlwhssbgks	lklsshngczwsbkaehg	TODO
odrzrlmzrrdztaqbscmgbcmydafohlp	dlraccalorrmrdtqsmbmdfhpzzzbgyo	TODO
mqrkpthaoiomknhpefzwxwuysgdwowhthill	qtinfwgwimrphookhezxusdohhlkampwywtl	TODO
bsnaysy	ssbnyya	TODO
krdrritxahugnfgbc	rihfkdrtaungcrxgb	TODO
ukuvtezpvxssutrtfcqwuyzzjmctfmxyqmguzuubaneqafwaokojikjcmjmfxwusqrvzstbxtrbcznsuftvridftgbrn	kextcymmmunfkkjwrtrntdbuutzvsurfquzjcfxqgzuaeawooijmmxuqvsbtbzsfvifgrvpstwztyubqajcfszxcurtn	TODO
dmspkogk	modskgpk	TODO
syphwfruksn	yfsspwrknhu	TODO
zdoxssqgmsk	dsszosqmkxg	TODO
dgpvhh	ghdphv	TODO
ihrgheedfynwpnthwfjaokkroyaoeenunywsxdvzvdvbyulkvabzbdyjofubbsrpezcmhe	heynfkyeydduadfszeirhefnptwjokoaennwxvvvylvbbyoubrechgdwharouszbkzjbpm	TODO
cnqcrbigtbvwwaoqm	nbbacqritvwomcgwq	TODO
pigizy	iypgzi	TODO
yqzxqwqqxflf	qwfyzqqxlxqf	TODO
vkbcqix	kivbqxc	TODO
ogeuhzp	gzoehpu	TODO
bfgp	fbgp	TODO
sevwfsjesvjobqrk	esvqsvfjsjbrweok	TODO
kacps	akcsp	TODO
vucfhuxeyvxokdlghviyjyywgqloqkzdfpqjotqqjkgxhdaov	uuvdvyqkptkdvchxyxklhijyglqzfqoqjghavfeogywodjqxo	TODO
qyiqaqqljeqqbjwgpassbmxzmi	yqejamiqiaqjqbwpsbxmqlqgsz	TODO
foyvngvmbvjmvcdczjkladsdxnfytpufmshtgeurush	ogvcjdnpsesfynvbjvdzkasxftumhguuhvmmcldyftr	TODO
eluaqujfoghene	lugeeuqjohnafe	TODO
tmglhbtjl	mbtghtllj	TODO
cojv	ocjv	TODO
uveeuxtzvenwqwuxayskfuzredhapyvojaupxfqtpdkshmpauftpncdqubwfnzp	vxewyudyafdmfcbzueutvnquasfzehpvjuxqpkhputnduwnpezwxkraoptsapqf	TODO
amofnfcjypsuoxq	mfpxaoncysoqfju	TODO
glfhhgfkdpzdmzanfuawiaenzdfditntklxybwxixiglkztuztgwqynjrdmzil	lgpzuadtlwiztydlgfhfdzmafaiezfinkxbxxgktzgqnrmihkdnwndtyiluwjz	TODO
yofwvbkrewmgjrftnahnadnxlzrbkwpkgetohmxhkcymfbggvyphejsqvrixcsbith	obwradzwemcbyjrshyfvkemjfnhanlrkpgthxkyfgvpesvicbtwrgtnxbkohmghqxi	TODO
wopnobpvpzccg	obzwpoppcgnvc	TODO
qieggsilafwgrhtxxfdqzuzp	isfhfuqegiawrtxdzzglgxqp	TODO
inowtpdlinpqynj	npnniotdipyjwlq	TODO
pokr	opkr	TODO
inlfmiwmaohdytnmhzk	niotzilmwahynhkfmdm	TODO
bwgndtkrgprjrxkqyamtfnlgthftbdmkxqwtncejsjuzmvytpxrsgbtnqdmfbowrpoushgkgngwo	wtpxanhdqcjvxbdooggbgdkgrrkymfltfbmxwnesumyprgtqmbwpuhknwnrjqtgtktjztsnfrsgo	TODO
vlrzvdmguofycqrt	ldoqvrvmufcrzgyt	TODO
zhgyjy	hyzgjy	TODO
edc	dec	TODO
zpoigqi	pqzogii	TODO
hhorlyqcwfp	hyfholqwprc	TODO
scdngcibdpwgsbntrhinqygqeasvsyrcmelvwzto	ccpbhyayezsdgidwsnriqgessrmlwtnbgtnqvcvo	TODO
asysrctmkwsexbdmetudphcpwskta	scwbthsayrtksxdeupcwkasmemdpt	TODO
hsnnnvlsqmxbweqnkksdcfnulfqpi	svmekffhnnlqxwqkscnlqinsbndup	TODO
jsoqzo	sojozq	TODO
bzimi	zbiim	TODO
uojxtvi	ovujtix	TODO
gouwozgcwxrgwxzwm	ozxxguogwrwzmwcgw	TODO
dkegcqwtu	kqdecwugt	TODO
yklkqw	kwylqk	TODO
sgau	gsau	TODO
adrowvtrtvmzun	dvvnarwttmuorz	TODO
fvfpjloqsqqfkyk	vlqyffjosqkkpqf	TODO
cviyymsdncylkyyedvttjsuuqkbvdzjqrhyfqyzvdgqfywaqbtzzfansritndnitfjoqphwxhalkrtgygvgbjnbyezfddyrjsvqmlczyxislskavfqkbolxxhtgnti	vmcyvskzhygwtainjhatvnzyvcikqlticiysnykydtjuqbdjryqzdqyabzfnrtdifopwhlrgggjbefdrsqlzxssafkoxhgtydletuvqfvfqzsntqxkybydjmylvbxn	TODO
rdhnvymnovegwnppqpchrfvqwtnnbp	dyvnpftprhvmoewpqcrvwnbnngphqn	TODO
toqqyeshp	oetqyspqh	TODO
qfzyfuiajteaavwrmz	futvzqzfijeawmyaar	TODO
iwbbmketdchmlaixjvirgbr	wkcavbibmedhlijigrbtmxr	TODO
lrwjognkugeahzuolbcr	rggzblwonuehulcjkaor	TODO
zlonsrbdncyknraliaffyqdjmmxzqnluvohgnilelouhjktpbkhemxcwjjackdkzaiizatsopdrgkpjmkschdagaxcjtsztfavptmfpmvwaotxidkepduuso	lrcraqmnoiokkxjditdpsaczvfwxeuzosbnynaifydmxqlvhnllujtbhmcjakkaiasprkjkcdgxjstapmpvatikpusndklfjzugehpewczzogmhatftmoddo	TODO
ymqnv	myqvn	TODO
tcclwzc	cztcwcl	TODO
vgkk	gvkk	TODO
nqxhepukejuqxmjzpioquauvdcusxdwalvjjszscpf	qpjmiacdvzfnxeueuxjpouuduxwljssphkqzqvsajc	TODO
eztradrotuntaqakrurqshxj	zduquhetartnaarrsxrotkqj	TODO
nfhbzhbjkxlcrjrcbztgxvzzurzgtkpnx	fhxjzvrknhzbklrrbtxzuztpxbjccgzgn	TODO
fvktfbswvscmronroegnuyvontqjvqvfoioay	vbsoeytqifkfsvcrnoguvnqvvooytwmrnojfa	TODO
zyrnfgvjxtalhdesptejnokzs	ygtdtozrfvxahepenksnjlsjz	TODO
eydwlabgksqvvxgxk	yasxedlbkqvgkwgvx	TODO
eiri	ieri	TODO
aqslinl	qnasill	TODO
liioc	ilico	TODO
alckmk	lkacmk	TODO
ameeesqpt	msaeeqtep	TODO
nyjpeuirmmrubfshbaxpaglguzfdslarbbpnwcronkdbdileopglignpdfckqwutynhuzlpowaunhtcherssptgburgoyohmgplimcthyxhblsjg	yumfagzlbckipgfwnlatrtropcxsnjeimrbsbxalufsabpwrnddlogindcquyhzpwuhcespgugyhglmtyhljpruhpgdrnobelpktuonhsbomihbg	TODO
qzoiymuvmpdss	zmpqoyumdsivs	TODO
vhbk	hvbk	TODO
hjchkbftffrieaawgsnz	jbfashckffreagnhtiwz	TODO
cwkjqoorxylmufsourcthepjthl	woyfrehckqoxlusuchptljrmotj	TODO
urkqbpdzodvn	rpdukbdovqzn	TODO
hxmkdwqvslhgugascblmnktptpbecmwlxcitmjwgkaz	xwlgbkpmcjahmdqshuaclnttbcwximwkzkvgsmpeltg	TODO
jxjvxp	xpjjxv	TODO
omxpifd	mfoxidp	TODO
rqhahrlwx	qrrhhlxaw	TODO
ouxnskkm	ukoxsknm	TODO
ahkogypiwiufavhqyquljwqkvlrovufeubzsdtyrpcnka	hyivqwlubtcakgpwuahyujqvrvfuzdypnaoifqlkoesrk	TODO
zdcsrbouizlup	dbzzcroilpsuu	TODO
qjvxqzbrjnd	jznqvqbjdxr	TODO
efkwjihndzvoq	fizekjhdvqwno	TODO
gzko	zgko	TODO
zjdqkvvoityfwlg	jvtlzdkviywgqof	TODO
mbuepkzsayxdnqvhyjwwlqmbmkkacdudryeyuxcjqgnyz	bkyqjqkdyxgmupzaxnvywlmmkcureucqnzesdhwbadyjy	TODO
gyr	ygr	TODO
wbdipnemrgdcwvqnsnifrndwpqpuvsejynekqet	bngvnnqsnewdperdwqsirdppveyeqtimcnfwujk	TODO
puhtihk	uhphikt	TODO
tqlijhuajnoe	qhntljujoiae	TODO
ymnovphaomnyendfomildhpffsyzxtxrichvameywfrfac	mpmnmhstcmfcynvhonedoidpfyxxihaewraoayflfzrvyf	TODO
oeswnkvsfpcjeo	ekpoosnvfcewsj	TODO
ptxcy	tpxyc	TODO
gxcxemfjox	xmxgcefoxj	TODO
xkmnk	kxmkn	TODO
ptknyphbicepx	tpcpkyhiexnbp	TODO
gfptppdfsqwnmdscnukrntoggpaazeeyhgejqbajjdpoqrqimfagahiylguptux	fpqdutpegbdrfhgugppdswmsnknogazeheqajpqqmaailutxtfncrgayjjoigyp	TODO
hsenjutzl	suhejtlnz	TODO
qfljlxflyrjyitzhaqkj	fxrtqqllfyjizakjlyhj	TODO
zzlahtbkbpfctnkiujxlapind	ztpnjpzlhbbftkuxaidakciln	TODO
glqrqwvdi	lwgqqvird	TODO
qaqtbbcptzn	abzqqbctntp	TODO
uucqhzonezaxaehwvgrenvqkxlcifujrgumjdsimaahpwbchxgythqzjd	uzzegvluusabgquchoeaahvrnqxcfjgmdiahwcxyhzdqnxwekirjmphtj	TODO
fhmxlujskgvphtebaqckvfvrydkfvixyfniicabkvu	hugtqfdinaufmljkvheacvvykvxficbvxspbkrfyik	TODO
ehkdyl	hlekyd	TODO
vfr	fvr	TODO
gbavqdfarytuyxhvdaikocqkshgxjpsdqaooljixxu	bdyxachpajugaqfrtyhdioqsgjsqolixvauvkkxdox	TODO
bfchehdujgukurlpmwgvolhvlkh	fhgrwlkbcedjuulmgohlhhukpvv	TODO
uwrclqkyknxtfxbyzdseeddcgzowjspq	wqnxddzsurlkkxfbzsedgojpcytyecwq	TODO
vqktpnne	qnvkpnte	TODO
gww	wgw	TODO
xjmj	jxmj	TODO
jfiybyitaialntviuupdgthfgaclzjzzwtqqqvxzzvlvbisiuqguvnjksxceiqorwfcbcjdxviugjxydvopuqoyihypivokpnngnrdgfrsyzlmdxr	fyitutajtvviqnxqfjixooyondsmjibiaanvupghgczzwqqxzlbsugvjsciowccdvujyvpqyhpvkngrgryldrytlidflzqzviukerbxgduiipnfzx	TODO
hzjhktkjqiwryuylgsdfnhslcisfget	ztiushiehjkkqwyygdnscsgthjrlflf	TODO
yhzvmmzckrwk	hmryzmzkwvck	TODO
pjohiwrxaqbmnwlkbleszufdxpdwqbpsjicupxjufpbgiiintiyvokp	jwqwlupbixpiikpoirabnlbezfxdqpjcpjfbiityophxmksdwsuugnv	TODO
pdln	dpln	TODO
wjljxiecmzpjhdeaqedbjlabovextkkaqaftkkbwbaehae	jizdelvkakaewlxempheqdjaoetkqfkbbeajcjabbxatwh	TODO
gximqhitsotdewnddnbxaaaeekhbssfwdrrtrqmqg	xhownaksrqgiqistendbaaehsfdrrmgmtddxebwtq	TODO
hfctfhw	fhhcfwt	TODO
ruaecq	uqrace	TODO
ntisqub	tuniqbs	TODO
aozti	oazit	TODO
mxwtz	xmwzt	TODO
odv	dov	TODO
libmumzqddtkcukmbsjeozihpld	imduszllbuzdtckbjoipdmqkmeh	TODO
jewfvdjrbkrumrodzisvbjiyknpg	edkrijnjwvjbrmozsbikpfrudvyg	TODO
zsggcx	sxzgcg	TODO
yzbadzezcmfsbcpftnpfmeadccaoiyknpfmcqghpasfoqqytmnojbuoqloroawrfmxb	zzmcnecyfgsqnuowxybdecfbptpmacaikpmqhafqymobolrarmbazsffdoncpotjqof	TODO
azfe	zafe	TODO
