string	array(string)	array(int)
barfoothefoobarman	["foo", "bar"]	[0, 9]	TODO
dcacdabcd	["cd", "ab"]	[3, 5]	TODO
iuwvllmkxvlliuwgue	["vll", "iuw"]	[0, 9]	TODO
vftdjjdjjvftykudjjvftpfq	["vft", "djj", "yku"]	[6, 9, 12]	TODO
ewciswwiswwiswwioxnuewci	["ewci", "swwi", "oxnu", "swwi"]	[8]	TODO
onlkinldryqxxtxxxfnlkdnlkqyrrfnlkixlupwhxzldbyup	["txxx", "qyrr", "fnlk", "dnlk", "fnlk"]	[13]	TODO
ckksrickksri	["ckk", "sri"]	[0, 3, 6]	TODO
i	["i"]	[0]	TODO
n	["n", "n"]	[]	TODO
jjj	["j", "j"]	[0, 1]	TODO
uuu	["u", "p"]	[]	TODO
fff	["ff", "ff"]	[]	TODO
llllll	["lll", "lll"]	[0]	TODO
llllllll	["ll", "ll", "ll"]	[0, 1, 2]	TODO
vrvrvvr	["vr", "rv", "rv"]	[1]	TODO
wowowowo	["w", "o"]	[0, 1, 2, 3, 4, 5, 6]	TODO
wewewewe	["w", "e", "w"]	[0, 2, 4]	TODO
gcgcgcgc	["gc", "gc", "gc"]	[0, 2]	TODO
alalalal	["al", "la"]	[]	TODO
fffuuuc	["f", "f", "u", "u", "c"]	[]	TODO
iziizizzizi	["iz", "zi", "iz", "zi"]	[1, 3]	TODO
lolloloolol	["ol", "lo", "lo"]	[1, 3]	TODO
nnwwnnwwnnww	["ww", "nn", "ww", "nn", "ww"]	[2]	TODO
ocrrcrrcqqc	["cr"]	[1, 4]	TODO
remmemmeuue	["me", "em"]	[1, 4]	TODO
wrddrddrffr	["wrddrddrffrd"]	[]	TODO
voghmghmgvghmgh	["vgh", "mgh", "hmg"]	[6]	TODO
rrrhrcrcc	["rr", "hr"]	[1]	TODO
digggii	["gg", "di"]	[0]	TODO
uquuqq	["qu", "uq"]	[1]	TODO
wnsnwwswns	["wws", "nsn"]	[1]	TODO
cnnzczc	["zc", "nn"]	[1]	TODO
ottott	["ot", "tt", "to"]	[0]	TODO
mmmhs	["mh", "mm"]	[0]	TODO
jcbjjcjccj	["jc", "cj"]	[6]	TODO
djdjjddj	["dj", "jd"]	[2, 4]	TODO
jwmjwjm	["jw", "jm"]	[3]	TODO
wwjkwk	["wk", "jk"]	[2]	TODO
uulqlqqulu	["qul", "qlq"]	[3]	TODO
hghhhggg	["hg", "gg"]	[4]	TODO
klkkp	["lk", "kp"]	[1]	TODO
evvffvf	["vf", "ff", "vv"]	[1]	TODO
ppryyyyyr	["pp", "ry"]	[0]	TODO
ffxdxxdddx	["dd", "xd", "xx"]	[2]	TODO
rgggrggrr	["rr", "gg", "gr"]	[3]	TODO
niinn	["ni", "in"]	[0]	TODO
oootgoo	["go", "ot"]	[2]	TODO
hhhhrkkrr	["hr", "kk"]	[3]	TODO
itttaitiit	["it", "ii"]	[5]	TODO
hhahf	["hf", "ha"]	[1]	TODO
ddididiy	["id", "iy"]	[4]	TODO
httttthwtw	["tw", "hw"]	[6]	TODO
jjjeejye	["je", "ej"]	[2]	TODO
ijijjijnn	["ij", "ji", "ij"]	[0]	TODO
iiifjffiif	["if", "jf"]	[2]	TODO
drvvdvddrr	["rr", "dv", "dd"]	[4]	TODO
dmmdi	["mm", "di"]	[1]	TODO
tuxxtxtuxx	["tu", "xx"]	[0, 6]	TODO
rrhrthrr	["rr", "hr"]	[0]	TODO
zgppgggpzp	["gp", "zp"]	[6]	TODO
bcbnccbnnb	["cb", "nc"]	[1, 3]	TODO
dddz	["dd", "dz"]	[0]	TODO
jjujuquq	["uj", "jj", "uq"]	[0]	TODO
yytyty	["ty", "yy"]	[0]	TODO
irrriiirix	["rr", "ii"]	[2]	TODO
mzzlzmzlm	["lz", "mz"]	[3]	TODO
eeesqqeqq	["sqq", "eee"]	[0]	TODO
aeaaeaaa	["ea", "ae"]	[1]	TODO
ararrbr	["rr", "ra"]	[1]	TODO
qokqqoqk	["kqq", "oqk"]	[2]	TODO
sqsss	["ss", "qs"]	[1]	TODO
wwkwkwwqwk	["ww", "wk"]	[3]	TODO
xgogxxggox	["go", "gx"]	[1]	TODO
bbbwb	["bw", "bb"]	[0]	TODO
pveevvpe	["vv", "pe"]	[4]	TODO
gggfffcfc	["ff", "gg", "gf"]	[0]	TODO
nnnsslllln	["sl", "ns"]	[2]	TODO
zlliiiizii	["li", "zl"]	[0]	TODO
aaallllaat	["ll", "ll"]	[3]	TODO
cycgycc	["yc", "gy"]	[1]	TODO
wmmmmqwqq	["wq", "mq", "mm", "wm"]	[0]	TODO
oovooom	["ov", "oo"]	[1]	TODO
krrckrrcck	["krr", "rrc"]	[1]	TODO
jjrjnjrjjn	["jj", "jr", "jn"]	[3]	TODO
xggxgssxxs	["gs", "sx"]	[4]	TODO
nnqqtq	["qq", "nn"]	[0]	TODO
vyuyyuudu	["vy", "yu", "uy"]	[0]	TODO
mycammyccc	["mm", "yc"]	[4]	TODO
saoaaax	["oa", "sa"]	[0]	TODO
ampdapa	["pa", "mp", "da"]	[1]	TODO
ssasnna	["sa", "sn"]	[1]	TODO
ioaaooo	["oa", "ao"]	[1]	TODO
pmwm	["wm", "pm"]	[0]	TODO
bbloboboob	["bo", "lo", "bb"]	[0]	TODO
ltddlt	["td", "dl"]	[1]	TODO
pswwss	["ww", "ss"]	[2]	TODO
bjwbwbwj	["bj", "wb"]	[0]	TODO
nuffunv	["nv", "fu"]	[3]	TODO
wbcppwpcwb	["pw", "pc"]	[4]	TODO
aexaaepx	["ae", "px"]	[4]	TODO
nncnngncc	["ng", "cn"]	[2]	TODO
mnnmnnehhn	["hh", "mn", "ne"]	[3]	TODO
qdqoqqnqq	["oq", "dq"]	[1]	TODO
xvxkxvvx	["xv", "xk"]	[0, 2]	TODO
iwiiih	["ii", "wi"]	[1]	TODO
gogsrg	["gs", "rg"]	[2]	TODO
pppoopoj	["po", "op"]	[2]	TODO
ojtjotzjo	["jo", "tz"]	[3, 5]	TODO
upuuygypgp	["uy", "gy"]	[3]	TODO
cdldddll	["ld", "cd"]	[0]	TODO
ysxsx	["ys", "xs"]	[0]	TODO
cccccix	["cc", "ix"]	[3]	TODO
llcblbcllb	["cb", "ll"]	[0]	TODO
jjttej	["te", "jt"]	[1]	TODO
ttytttyt	["yt", "tt", "te", "ye"]	[]	TODO
wrqrncxaotwrqrnc	["rqr", "ncx", "wrq", "rnc", "aot"]	[1]	TODO
ppnnpggnngpgnkkpkkgggkknnnnpnkgpggpnpknpgp	["gpn", "gpg", "pkn"]	[30]	TODO
mzmazamzamumzmmzmazuzzaazzzammuzmzamauam	["zza", "azu", "mzm"]	[14]	TODO
atacacntccattannataancancacnttcatnnn	["nat", "cat", "tan"]	[9]	TODO
rnrnnlnnrrrqnnqrnnlqrqqlnlnlllqqrlqrqqrllnnrnqnnqlqrnrqnnqllllnq	["llq", "qrl", "qrq"]	[28]	TODO
bbbcmfmcbcmbcffbcfmcffcffmbcbbbbmmbfbffmmbmmfbffccfmfmbmcmmbffmcbmfbbmffmbbbbfc	["ffm", "bfc", "bbb"]	[70]	TODO
umcccdmdmmcmudcmucdcmcudmdcudcummcdmducucccudcmmcummumucuuududumdmdccduc	["ccu", "mdu", "cuc"]	[35]	TODO
jjmjlomojloojmmmmlmojjlolmoolljmoljllllojloolmooomojlljmojmlollojm	["lmoj", "mmmm"]	[13]	TODO
eklkeyyekkyylkleeyykkklkklyyyeeykklkleyykkyeeeeeeykkkeeeleyeeyyklelyeekyklykk	["ykkk", "eeee"]	[45]	TODO
vvkcckviiiivvicicciicckvkckvivkvcckicvicviikickcikkcccivikciivccivccckiikikikcckcvcikcvivkivicki	["ivcc", "ikci"]	[56]	TODO
gcchcgchbgbbgcbbbcgccghbhchcghhgbbbgbgbhghcgbgbhhbbbbhbcbcbbbcbbghbbhhchghbbbhcchcgcbb	["bhgh", "cgbg"]	[38]	TODO
nrccmrnrnncrmrcmncnmmnnrcrnncccmccmrccrnnrncrmrnrnrnm	["nnrc", "rnnc"]	[21]	TODO
hhhbbqqbhbbbbeqeebqqqhbqeqbqeheeheqeqbqqqeeebhbbbheehqhhbeqbehqhheeqqhbbeqbbqhheheb	["qhbq", "eqbq"]	[20]	TODO
xynnyeexxeyxnnnnxxnxnyeneexxxxyenexynynxxexxexnyenneyeenyyxnnnxneeyexeeenyeene	["xxex", "ynyn"]	[35]	TODO
skskosksoskshhhhoosshhhhhookoohsksohkkokokhhskkskhksksosssosshhoohhkshosshokskhokssokkkhhksosookhho	["oksk", "hoks"]	[74]	TODO
zvccqvvqcqzvqzzqcqzvccqcvvzqzzqzzzvczvzczzccqcvvzzvvcqccqvzqzccqvczvqzccqqqvzqvqqv	["qzzz", "vczv"]	[30]	TODO
fwssdwswsdsswddfswsdsdfssfssssswdfddddwsddfwdfsdsfdfssffwwwdddwdsfdsfwffwdswffwwdfdswfw	["fssf", "ssss"]	[22]	TODO
zzfzzzuffuezufuffzeufffzeuzzfzuzueeffuzzzzeeuufufezzfuufffu	["zzze", "ffuz"]	[35]	TODO
nynlnycylyccynyyclycylcycccnynynnncynnycncnnylncnnlnnynlnlcncnylyclllyynclycnlly	["cnll", "ncly"]	[71]	TODO
pppeueupeeuddpueudeepdueuupudppdppupeupdpupdpppudepdupuuup	["depd", "upuu"]	[48]	TODO
duduooouoonoouoouounuuouuudoduududunondddnuonndddunuudoouuduodunduooduudd	["ounu", "uouu"]	[17]	TODO
uccciduiiciudiidciciuduccccuiuddudduuiddcccdciicuiidcuddudidccuudccciddi	["uddu", "ccui"]	[25]	TODO
mcccmsbcmmmbsscbsmcmcmbsbscssscmcmbsmbcscsscsccsbmmsscsbcmbcmcsbbbbmmcmscmccsmc	["bsbs", "csss"]	[22]	TODO
hyyhhyxypxyphhxpyhxhyxhhhphxpyphxypyhxxxhpxyhhyxppyyxxxhxyyxxyyhxhxyyhp	["phxy", "pyhx"]	[30]	TODO
fhuuhtuufhutftfhhffutftftuhfuuhuhfutuutfhtuhfuutfftufhfuhtf	["fhhf", "utft"]	[10]	TODO
zfszffzszqqfsqzqzzzffzqfqszsfqqsqsqfsfsqfsfszzzsqssqfzqqqfzffzsqqzqzzsfzffqzsfqzqsfqqqsqffqfzzq	["fsqz", "qzzz"]	[11]	TODO
fvvlvxflfxlxlvvxlvlxvxlxxxvlffvxxfxfllffxflxlxvlfx	["xxvl", "xfxf", "ffvx"]	[24]	TODO
vmvgmmvmggvmmvgmvvgggvmvmmgvvmggvmmvvggmvmvggmgvmmvgvgmgmmvvmmggmmvggvvmmggmvggvmvmgmvvmvggggggmg	["vvgg", "ggmg", "gvmm", "mvmv"]	[31]	TODO
leelsslllesleeesseleessleelsleslseelleeeeelllelssllsessleseleleeelesslelseesleellslsssselleslellelllleslleslslell	["sls", "lll", "lel", "lle", "les"]	[97]	TODO
fnbnffnbfnbfbbnbbbnnfffnffffffnffnbfbnfbfffbfnbfnfbbnbbnffffnnnnfnbfffffnnbnbnfnbbnbbnnbnnfbnbbnfnbfbfnnbnfbffnnbfnbnbffbnfffbbnnbfnfnbbffnbnfn	["bfb", "nbb", "nfn", "fnn", "nfb"]	[89]	TODO
xsnsxxxnnxxssnxsxsxxxsnnxxsnnnnssnnsxxsnsnnxnxnxnxsnsssxnsnssnnxsxnnsssnsxxssxssxxxxnxxnsnxnssxxnsnsnsxsssnxnssxnxxnsssnxnnnssnxnxsssxnxnnsnsxxsxsx	["sns", "sxx", "nxn", "xnx", "nnx"]	[35]	TODO
blaykyjqaaenhxpeaanunmqdlynbqxyuclzddjeqcwxltdjrzfdqqmkcjsxaytommuooeyuznglgcokhkbiblxxwuswnnhkskcgykmlsfmagrsvpcwkblvpdhkqfxueoeazvmthqpphumsoihckbmqwdbravdmakezpvtgrvyvzhfuctxzdoeluyewdkcqraqwucqqscroyyhbkawwwlzpeebkynbxzytubptrymzxpfueifrsyrmgftnwgutjakksqizcmnixiubhbneicwrrdcqhxctedilkfynelaslwcophtjyxueexsdoqclkgxvtjypblmazzwihntweeguwnyhxsuuztacwlthxpjmpexcsfxunfiuivsxhjrfvlgfmbjoeygqhhpdgnrhirspqgdzytfzmlavacfxbysxwxsekinkvberqmttfrtemrgebrbgxtftpepqxfwtsrbwpzncljfhwlzjewvwquxntamhitykmpjdifjlrcunoufriunqixxreovezzumikspxxojapfsbhibknumkrpydbgdbmobvtxgfryfyoeakesympjyygdlzpcwqdcghaoglalqbpqrnwmsmnipcdwhaqkdkzpdnkprmuhtsibooljgggyopzkheyaurjytnobbpezeqbtlzwktepqnpofnfpllrqeclrduhxtaloyyfpedjsergdctaoklvybxxvrirbfecvhrwzjeozfqxgjqdqtttdjjlogkgtvvmoxrbifcicpnwtxypfeunamtozzxcltaihtkjvdjmafcgdbyavdnyogzogxempqxtpvvbtmtrqwoejaebnmioiipgnziaexrntxwkodavlscskitomtjxytittfrinsacuudplnoxweyjqmqbfalwrvdbojkunkevckosopvjnnrmkhtqcmrwhccmvzjykadasybjoprviecezuohgaelgzfeztjsgpbdoghplvwvjmjcgqrudfnpfaqirfmbhlwkbsezjrvypmbywzzvfdwhqyccuaxkrrvnigzjklbefgjsgjfriswqhxfkenrftqiypzoeycowumjmatpaibnhvixjnjttirkjrtnmbvghguncqijqkfihfdlfhkycffllygpaeypfdigepwkeskzxsrneatiiylvxkwxuazoqidkplrdifxdkjeuhiucynkgsgphgfkhfwxgajpfgznnhsurmispzlyskwensuhkpanfjfjupfvcenbvicwzonsruytpzydiuqhmnljaybghbqobhhbehcfbklxmesxtviaylcvxnkaobshmexvzfwsqzywkptfbtpikywwttoqdjisidhznmsmsityjbvxzbdkaljgsehoncgahyzhjonqkctnxmkxlwulaskkvngvpuyrzyvhfrimwtklfljyzmearvkdyatowedujtkcmkaciskffnwpbtfaxxnjejmtzkqjiulmcritikypsnjcgtgpjjrnyhgyxfoxbnwdtwcrgbydwshqavzhbrhpvlucvfppikfrjgmudjyvdwgqzgfsbjmpbjrptucrhgmluyqyocqyxjtmuyyfopgjlorspwicqxoyjvdxsmgyzojyikobexqjycquenesmtpdmaeykadkbifskktwvjknloljupnjv	["htqc", "mrwh", "ccmv", "zjyk", "adas", "ybjo", "prvi", "ecez", "uohg", "aelg", "zfez", "tjsg", "pbdo", "ghpl", "vwvj", "mjcg", "qrud", "fnpf"]	[935]	TODO
cqaymhbqgstmmybvyjtmvmhezaafrfkglrismcglwhnufpfaygwllckanrbjixsgnlwrafthtvbgfmybllrraokozwwwqlfcvnemytywuefemabxrhnbaesailhtvohyvhvbyqcsqpsvyuylbcrpcqjvvrgszlofvgmhyqzpaxrzvlatykoirwyinnhngyqriwctotksduiiyteuaoflebgjplozpidibzeyktmobpfeofuwgeuphcybyxbylhkrbtqxqiedivrdipsvewrmelxjcccajbkpixwuqxgoyfukfxgfjfoakdgbumfnstslpaaqojnvaiubacmpuajllsvqfxuyewedkbbqpzkjwlptnkkivfzcjfnlnwenafyrhphlpspvpeuymlkzkbcvmvmdyoauugeazmrgevdewpygbfgxhmyygvyizzwocistzahehmecknoxqkaryzlidphdzgutrxqdmrrngfvlqpcemnwvioqyowymdxqxaeiwvybdbohrtqrauyhvwfbpietysxhcwpensbazsdefbwbjhxlcywohxlebcknehnjepugsppyqxeeuxltlclidvnlzepeksyksshhileuufcmyyadwdssvmufocfjwbdqutrriwzwntgmwjtjjftlukthbcfmywixzjyimsaeryoscqcxkqcqxhvtyxqojufniakeorfpqusinrqpmnbgpmmjewijdscnobnlkjhrizymfptoystyejgpmraoqnrngbeldlmylvfkwuabviextgijfoilrypdzphdhyjvbbgtyjnhknuyifgnurpdlzvbpolbxdoolkbddpkmnlvhkrdlsekzecazhrbuvskcpwuevqoqrewovwybidaxuzxafonxfeedizfjazplgxjrjcktufptfiivdhjrhqxgjyngiybxhznftecbfunwrhnxwongnkttevmibwqxrzszzwbddgxxakakaghclnhllizrbqytjmkjzvadroxlyosuhgkwsxuulodwnjzovkwfcmrgbjbzvguuoarvopejcfhvlbetwigddpebabbhqnbickykmaflhmcvscglrcmvommsiwgobjfjrbvgexjlexcyfmpwlhnjyfmknlagfbyifbrvubtzuhsznirzpqssledzkqgcdndrpvxcodthhrqpymgywimoitozwkmsecadpmucckjqoebwkalutnkpfjpnrtmwbvwlzryttuilucolinydorecbdxttzgivfgfwiuewrbeesksmrnaxjncahbwhjqtqacttttpuidghmwsohuedvcquytacswnodflogbkwlhcxcwfqrfbnzrwszhwxgbezmhthvacofmfppvafseyswlmfiusranrwpzcwymdaarjqiplhddzwklneqkrpfivrwdnbcyfiabocqyjlqyovdwrbuslplovccqjkzqzartikrtxhwfcxieowsjv	["ngyqriwctotksduiiyteu", "aoflebgjplozpidibzeyk", "tmobpfeofuwgeuphcybyx", "bylhkrbtqxqiedivrdips", "vewrmelxjcccajbkpixwu", "qxgoyfukfxgfjfoakdgbu", "mfnstslpaaqojnvaiubac", "mpuajllsvqfxuyewedkbb", "qpzkjwlptnkkivfzcjfnl", "nwenafyrhphlpspvpeuym", "lkzkbcvmvmdyoauugeazm", "rgevdewpygbfgxhmyygvy", "izzwocistzahehmecknox", "qkaryzlidphdzgutrxqdm", "rrngfvlqpcemnwvioqyow", "ymdxqxaeiwvybdbohrtqr", "auyhvwfbpietysxhcwpen", "sbazsdefbwbjhxlcywohx", "lebcknehnjepugsppyqxe", "euxltlclidvnlzepeksyk", "sshhileuufcmyyadwdssv", "mufocfjwbdqutrriwzwnt", "gmwjtjjftlukthbcfmywi", "xzjyimsaeryoscqcxkqcq", "xhvtyxqojufniakeorfpq", "usinrqpmnbgpmmjewijds"]	[187]	TODO
linkstynjhccyxsmcwbsgpyqcleumwxziedexkjzpfisiklqygptximiiiqgikfaxezsxgbfawnekxwzfpgwvhsjxgbnvajqngoaugogphrisagxjqnijbtmxvfzkqawaiyolrxmpbpdtxzktyeakuwdufqpjloyvrtlcpzszusgtpwesezhlzfftjksvtqwygvpqnwkskwctigahebuvedsfsyuedqgmzxayxqqlzdwnmyawkgjzgatvxxyxrjaozqtasprpnaqumoudmzqclmcxypsxbhfqszdycrtrummsxrikoznoescgjzylsghcufndzlttxbakifqvtkpuhkaqlxhtfwxlqaokajedlnsjrnjywlbhstttonkkoltekwxhjjfjoxijateyjylafjckgnqqxgvopmflnbdhutqoywreytnokisjbnnfumeyyprinkzkekimkatquoupwzbbcqcbaoknmupenczjmpnvtlzzgicopymsbttkdedxlnvxtmnbfhoqcfsrxmwevnzdlgsbsihipqmvruozvgrekfmbimrsfliezkaocpvkenkqstrtbuxtlkjilykfkypdztgwlpkyhqlmnsoznuoxpbmmalshawfltavjjyfzbyyzqrekmsbftxsuxfvbfupxoonltthiqlniitfoceyhdxjhwwufqywctpeaddfubtzwejbgckyeoedofcavnefdsprignqmosmkyxvnbatmzixjqbterqaeeqhsktotcqcnsecimqoencfkyqmzsdjhuxmpnqdstcbegahulcbxlelrvxotxlgiqcdyjbhkkeminsqxzukhokgpozwuhgzjrxukhvqbyrdtfqnitjxdacosjozzzapobkifrnaxdrnebhhvqtvlxptzmgeaittweauzvgrvjwelhdbttlwgntffdpojvwjcehwyaycyyoaogrdliwnbrtytwrsjryuqoqdsdyqytorvwtbrrzjcofqozpvoihedtcsingcdqzlmoobtfvhyftsjdrvwnywoprvhwuhziuavariprninoygoxnbatdrltsurzjbphtbbfwznpoczrrhowfircesxqgokpmtybvsajljbnhqvojpohvilykudverpwyileykcrckvlpvpdgxfpgctwdjjyylynjatczqxwbmvgzpmffskaqeauucplyrmeqogsffkaiyinsgrmlfdfbawfnpyivjfzbapantxbfmzxhoyuaawrqwzypwcbibudryyvfvodzfxrydnmrnlonhsqzqunuwnmewzbvhonwcveymwxflfrhmbtrylpexfpnszgmffpdftystwntflniooesptxfmetljlzxccxlxliglpdcgzqmhdlatupbldgwluxabsrqseajrauwvwmuwqosixivxbiqcmbydtbiqrrguggfbhvbjbisqrrttanhjzlvopjevysqiljdutpqvvphkvgeefdctlfwmqegbxedqcbjhgxxpeiwcofoyfrhyzhisdothsjizwtkgpoxrvxxlwhafnoofclmeppddbwmbtvmvbksolbpvesutvaqfrkbviowdogbjnxwqlafbtyouuaxhxkdbqolzzvmhnhzurmiswqjtdbmcsyloqominzgczcdyvqokalfehuufcrozqpfsnsacoilfq	["tjxdacosjozzzapobkifrnaxdrn", "ebhhvqtvlxptzmgeaittweauzvg", "rvjwelhdbttlwgntffdpojvwjce", "hwyaycyyoaogrdliwnbrtytwrsj", "ryuqoqdsdyqytorvwtbrrzjcofq", "ozpvoihedtcsingcdqzlmoobtfv", "hyftsjdrvwnywoprvhwuhziuava", "riprninoygoxnbatdrltsurzjbp", "htbbfwznpoczrrhowfircesxqgo", "kpmtybvsajljbnhqvojpohvilyk", "udverpwyileykcrckvlpvpdgxfp", "gctwdjjyylynjatczqxwbmvgzpm", "ffskaqeauucplyrmeqogsffkaiy", "insgrmlfdfbawfnpyivjfzbapan", "txbfmzxhoyuaawrqwzypwcbibud", "ryyvfvodzfxrydnmrnlonhsqzqu", "nuwnmewzbvhonwcveymwxflfrhm", "btrylpexfpnszgmffpdftystwnt", "flniooesptxfmetljlzxccxlxli", "glpdcgzqmhdlatupbldgwluxabs", "rqseajrauwvwmuwqosixivxbiqc", "mbydtbiqrrguggfbhvbjbisqrrt", "tanhjzlvopjevysqiljdutpqvvp", "hkvgeefdctlfwmqegbxedqcbjhg", "xxpeiwcofoyfrhyzhisdothsjiz"]	[873]	TODO
odpogirbllgdfxvhhlrqckyiucqjmjmogqwqxkklvzqnnefozbvnungnrrfrkymcggbvcurykmqtewygazybadcvillbeqmqrtsehjbshknbnqevbbgitvlcavmygdgupkterpfovlykybnhbyklnwpwmqmeqjtycpmaffzrjotzocfykaeqqrilzrnpomhptuihseoqxfpoohagqkrudjgzkvmguvswchbgpknpexfxhmvglkxkngpttqrvsuteztlthtlbtgdjgvpcrppesfsiwvfocynnjtzxlqdkidrywxkybuxnasekqxvdyyzxhcnsbzxnzrohajiimigshlxgqvegnjvffymyfzolswsybwptyiridryolmntjyunihotuwyttpjlsekbydnhnoadqvtacjwedcryuqjvomadgdbdmxhcqtnugmbjwaljjxcmbyhyfqyxpvdquvdwezzkzdihsxxkcclmosueznwdkgorpffrqkmpyrwbrhkeywggfdqlnikphjcwcqfdjklntrccolvwrbltpykzqjtgtxtxpuderlhzzfrljlrkkzyvfsyvljdouqqgepkyfrfkbthekomelubvbvdfxdwuorbcxflfpwwoemzmkcwhkazulzspxkgqdemdmofqccyvzoupqdwjrjzxvetuzagmfwmyckjaqclbqaokacivysyifjokqnowhkzowymikocuctrgzgdfyhqaxyxqqoawjectbncybsnmrwjsljtjxloxwltshnfmuqbjbzcbeatykgpjtlttufddgpamxbxuqbxlxifwvymnxqfbuvlcrqnuywykgysnuemyvymdimiapqigamuvlkcwzocwgefdoyhisurhhgqgnxqwmedlznncbaysyasadluswllbcyerynokhovybklqmwnfljxlauxkapujjmfciwlknrecbimtucvwyvntcnhjmctvnyuamexiygavhswnwmhmhktftjzphxaoytmfsxbpjswduqnxlkmawbmsgcidchlljowkqayrymrnljnyciduibtyzcyifebzzglbowragwwcphlmokyduvhfuctsjpeurnjmhfatnkxdaqxzjkmcnvqquoxzhwyqhzqxlzdtqzbnpmiefrvqkefexogunmwfcilpalqiqkayfuxelvchpqbbhshfadejinaubnokqzgvygqgbmdoppoenrxjnjdeurdjwfrikuoabhoquoyghaqovtrogicdjxjtffxgiponwvxdikgldrvvcksjpejgwbrcyrvtcsmvlmvmftlfnarrxjldtsasrvjplbktnowdqbdvplrdxwsxbzxpaaihlywhuzjlppoyoocyjguhltyobfuibqllgnemslocfvljibxysfczvoqjwwfaijxyyeupnemqpprmorkzdpcwydtmwugfmgafqbvbshknedinsbsilwfwjuvpcpuiipqxledztkisoejdekizcqhhgmwhqdlzquzytzfqptnhsuhuskkwhrmdiguzeaciprlqajuiaklhsscumlxvxmhrezsfewtiyyxdxucaepbfnzsctskbriihrvshtclholvqwfiquzwkiftxthbzlnfdythjzgmlihyunleltqjxwazetxgyicyldiamheqopvexrlqchai	["fzrjotzocfykaeqqrilzrn", "pomhptuihseoqxfpoohagq", "krudjgzkvmguvswchbgpkn", "pexfxhmvglkxkngpttqrvs", "uteztlthtlbtgdjgvpcrpp", "esfsiwvfocynnjtzxlqdki", "drywxkybuxnasekqxvdyyz", "xhcnsbzxnzrohajiimigsh", "lxgqvegnjvffymyfzolsws", "ybwptyiridryolmntjyuni", "hotuwyttpjlsekbydnhnoa", "dqvtacjwedcryuqjvomadg", "dbdmxhcqtnugmbjwaljjxc", "mbyhyfqyxpvdquvdwezzkz", "dihsxxkcclmosueznwdkgo", "rpffrqkmpyrwbrhkeywggf", "dqlnikphjcwcqfdjklntrc", "colvwrbltpykzqjtgtxtxp", "uderlhzzfrljlrkkzyvfsy", "vljdouqqgepkyfrfkbthek"]	[165]	TODO
ztalvoyboudozuyrcpvuzbadcmaceglbzjnwcpiygwddwnooxkomadefekvzfaclebsxqxixxjtxipkwfilvjosyzarlvmiitvuclbkytcnymhacbuiradmrzbzgqczcinfkapbgmfopxfjuxtrqmbakfrdpmpjzvdjnoikjgqpeplfevubxbmpubognwgofauleidyqpostgupdoqbpvkphniizkssbsigdmcgseidcbakrbazhndoajstvzvoyjwtwcztfcuzsawqmohwrxogfmkskmlbwpygmpnygtbipiabsebvnlymrsiotzlnyhkopjvrthfvrqovrlpdioaxglqzffhzvztyquwcofnppryniolacjnjphqhvniloehtausdfxoohxtikkltzkbdqcvmsjppepvkgescqmftygfrxcdpnuaccnhwnlpsbyaqvjbjgwbcpmlouewteorvbsfenhuyyysrevbcxdycfcfxffwzvrlcqavcevxkrcejqgowexozzkpsbpyczcyjfrazazwgicmaujhedcslnqtfxgzlhpgdzjlrqlnowkdukkflnjtcnfzgcjscstqybdwacqdoutakuvftkjljydmdfbqufodwxeanrzrramayfkmpzrlbubhxdndbrrbcmltbxvvifnpthszqkyyzmflfmewngiblvxklplvckypnjyckzdjxigtqothueplbodzwemhrelycuvtzrbgxqngbcjbvrqugmnpcqllbbogszzeyecbrtzvlkceetfhnglbxbzudtghavdvizudonrjjlyczzyudubbserhpnaumnxzukpajncudveggvgyzijepbdtyzicoubhkzezoxzvsrdbaajtswmnteygslhlmpwdyogxqxldhojeyumuwpntjpnrtiiqdzgttpjccsqalzkcndcnosccnbmafksimifidfrqoerjscofzylnjurqtismuknjomnzadwyitfvldbftqgiincecgaaxpevtrwgowcttvuvrrbvfiwgccufhykxjrlbvlqkrtcdjcpsmvoahojcfhzdfjsdbthovqioerzymewsbojrywmqjxmfvibueboiybskkytdkthapjgujpijezdncjnfrrwwkrdgwuaxtyqvfkzdecfkiijsiiufxuaprzttzghaattkuorffhrwisbadbqbrbqvcehbuomabqtsbvuwkslozzdlapngkudiexdfvavcbugfzgfmbowoidjsoqbzijclfkosizgfnrtotmwyuwviyxdfwhlzuufxkkahwuvzpuikjqsjkenstwonjmoujkkklnnstwfkuggjxbjgginzzroqneqitjukqnaenztndnnreqtcoybtmpoqjboithheifxosjrondpllvmwittzvpjxzc	["zbadcmaceglbzjnwcpiygw", "ddwnooxkomadefekvzfacl", "ebsxqxixxjtxipkwfilvjo", "syzarlvmiitvuclbkytcny", "mhacbuiradmrzbzgqczcin", "fkapbgmfopxfjuxtrqmbak", "frdpmpjzvdjnoikjgqpepl", "fevubxbmpubognwgofaule", "idyqpostgupdoqbpvkphni", "izkssbsigdmcgseidcbakr", "bazhndoajstvzvoyjwtwcz", "tfcuzsawqmohwrxogfmksk", "mlbwpygmpnygtbipiabseb", "vnlymrsiotzlnyhkopjvrt", "hfvrqovrlpdioaxglqzffh", "zvztyquwcofnppryniolac", "jnjphqhvniloehtausdfxo", "ohxtikkltzkbdqcvmsjppe", "pvkgescqmftygfrxcdpnua", "ccnhwnlpsbyaqvjbjgwbcp", "mlouewteorvbsfenhuyyys"]	[20]	TODO
poznrallsfqqcuhqucvedrythnvpoixgvlivmtfroybuafiuzdhmdkzoprjjmvfhzsrglfcdtbptyyedkufjdvcutscpopnaeksgrskxgbqzjdoupgqunqnjjmdrcjatujnohfjeyymhntjanyupjvdhxchdfhrgtniibapgyaduklrzbovsesdijofxsftlbptmeubkbetwseiczejokkvudbynslpagbutmijnymypfghtvvzjyrglozhqancytumpkbqbljzrzleuzogeosskddwwjkmmtdayeqgsyhadcwhhxtoskqmsdhnlrdetqdldtownynyzfkvkgeiohvbbrkvrscejwskcqfmsrcdjvauneltuzhmzaxjfxnxciqcozmqylxehtfgrrvozcvwcalftpndsldqqfbschwhuueiugnsazksppeolgfbooilcobgytesxrrfqwpgbryypkqqnzrtcmzcvfsolkujvuxkxllhlbtqvdcplroolsuzpqggwcfsulmzheksxsgqkjpxagjizcgvrfmwfansldxsbcfhjhxotlfwuxhgddmdotcqwmgpywejkktoqukwkustpwnigxziqfudqcoswfhjriqbmvtedkrusvnycqcqzrtfrfewwmndklehhrubtmllpebpxrfnumrmaeznfcsulwzgegqcinlysvwvvozxvzsnldpbtdizcshtyztgczhybbmdmcuhhagawdcarupqqldfqcxahmyfnrnxctmhvidsptffhwypflkzoczsidpddaiwkkbydhxorkgzyfntczmohgbskzvgpdlbavjtcthbsefpmuomsvvenekzoyeakscmojpunnmijcsuuqnawywyljwdxavcfvmcosbtolprlxuwhdwunjsezlbnmtmrgwcrnbxtwlefjpiwoedtvvruhbvaxpatrsevqbgvwwboulplsozmxyvmjyuttqgxavagejmaokilhjxwcmzdcbfjggmngisshszuzcbskoiacykqrberunjrouwunmagupcypbpclsglxlnxnspdutdkhgdgovylbyuysffippvoczsnxtyfckbhoedwqnyuusgahprmkddkmvhyjvtsyxwaocwmminkrmnhawamgvebfmjxpntvcglugfnuspdscsesmwibyfoeariekhgltmwnaztsvqpnsmirhlowckacvbtypwbiztdporteqoagvraqkivkevlcdjzoojvamsetsqqamgyxcfhkabptwqvgyiuqatgmltpodzizhclhzsapcpbkhelwpkthsvgojhwnkecrelhlohaumcegtylioysbuymgwhmyolyfdwcfbsslgkonidevmwtnmflpktvxzollpncfusrcmmkvzajavnlxrdowrhcysnbdxrlpalziebxncklnfdsfbuubzugevcbarnpqhnuikfdkifzsoxenpzwkynamncuvnjkgbtqtitslmdidbpyyvoimerwgrxmnveodrmroysdcwpwtklljdwqbdtaebujwhrqplqgbgwqlrdytjrmlwlnczltfkkmqkozpmezbcykrnbebifvhcfxzcqwkvhnfsqwrduidathohonfafwawchwqbfvfqihcezehjbxkffaabzgyiyibwebtmdmnhjmutjjlgkpxbheukvgdmbehzpicuwmzmejf	["ybbmdmcuhhagawdcarupqq", "ldfqcxahmyfnrnxctmhvid", "sptffhwypflkzoczsidpdd", "aiwkkbydhxorkgzyfntczm", "ohgbskzvgpdlbavjtcthbs", "efpmuomsvvenekzoyeaksc", "mojpunnmijcsuuqnawywyl", "jwdxavcfvmcosbtolprlxu", "whdwunjsezlbnmtmrgwcrn", "bxtwlefjpiwoedtvvruhbv", "axpatrsevqbgvwwboulpls", "ozmxyvmjyuttqgxavagejm", "aokilhjxwcmzdcbfjggmng", "isshszuzcbskoiacykqrbe", "runjrouwunmagupcypbpcl", "sglxlnxnspdutdkhgdgovy", "lbyuysffippvoczsnxtyfc", "kbhoedwqnyuusgahprmkdd", "kmvhyjvtsyxwaocwmminkr", "mnhawamgvebfmjxpntvcgl", "ugfnuspdscsesmwibyfoea"]	[730]	TODO
dhdyfpaiorrlxvvnenwufrckjlatsfckwrsbkhmfqmfwunqimjydvxufbscjmeyvgzhobplocfmkyzbqlrijxdqazdocfnmsepgpngfdsdgjguegkndjovoajiuqucehjjrudfauxzdswcoflvnmevtnxeiiktatsegpjsmqyjawmtchvtpwsgmqvuebfslmwerknqxogghygomlqrwepjrrtubcwcoqkdcahfytvqldjmnfnvjfaiebdgfozbzwthyvwbikovuueajrdcechievwzkgidajiecpgmdceekizympbyznjozkfwowolpgajojavmswxbucqofogbershgkkxxkizhbaxewdnqytxbmdukfshelpjkwqifebwugrhadsdwkblbreifqajovxfkwwvalsifsazkqkfczxezsnoerebhpgrgcqzbabuognxyapcmikfcalzeesdqwtyrmsxwvzidgqwjxtfmpsdjsgdqwqkmmzmuynaignkvsuamgzzmtgephcazwhcscwtxmxnbteqsidxduijgwomzdwyozxgvbawqpmwgtjoiklknjybknnlqmyzfcodxymlpkoqugjdozuvrgqjxjjdasgzhcunabnjsjgddnnmgceuzytiisknlnehdhkcmemxnlyqqokrtqkkopypwzawfszacleoalyrlrwmdgooyfewhfajqkurdwelwinciwajwyemuyjueofdrppqnonqhroivjqxudhfldtetkhffwxfgsyxgntrnhhzfumvepweuqjfafjpxhhsxvmsziiufaossscwdtbamhzwdleyvljnjauyqtgybcshvijzjimafcbbbgchfmsnwnwvmcvwfxjdorgehlswcjlxdcwbopthaoetwtnccplwzgxcgvtsclvlrjbdllsconcmodowunqoxwwjswyhwhiwfmoaquuzakclplomnikyzeslxjilafwplmjqydaxuuxmutucjwalxhleajeknbonqpjogotmbrpsyohiinjmjzyorfxdplmbpewqynkrdoslixsxybdsjlfvxksspfhqzjjkptsfqyfeaqzfwkquuylzksromhjcxrsiyrombbrgwzjhwfyfayohzopazyuhbdabdynlrnfweqsxyjzaianbyefkgjrupazgfeferzxufvifaypnffwajcinmhfrdqkbrvpxcjzuabjpclxgxbjoxxjwontmjgwjyahbmapdgdgsnswrjpoosuhufvynynplbcyquzhvgtbastabuyndpsahcekxcnbxdclejiwwiybrlgbeulamkpuimnmwiqbstyqkvhgfmufvvpttgxmmsbufwyxsnalmfoxdzzccwgozhqkywxmkabmrrnsdlsvfgocqaadyjmsepyfgclmpyuzcfyrfzhzwpvjjwsikxxhjcldeljmrtccabakvnwkxsyqgzpmvskahkrluvhuiqsodmxzjrtmsdpwuniyelxdkfwodjxkfqxxzuiluzvdkboqwumaudcoxyiysoznzmtdyiwkysupvcxjsdmnnovtwxlgtsbkxbgavahiqbrkfftmchzlzxdeedifkmhjqyngxsltjrgqfazpdyuuceiucahjlechglrszlp	["bcshvijzjimafcbbbgchfmsnwnwv", "mcvwfxjdorgehlswcjlxdcwbopth", "aoetwtnccplwzgxcgvtsclvlrjbd", "llsconcmodowunqoxwwjswyhwhiw", "fmoaquuzakclplomnikyzeslxjil", "afwplmjqydaxuuxmutucjwalxhle", "ajeknbonqpjogotmbrpsyohiinjm", "jzyorfxdplmbpewqynkrdoslixsx", "ybdsjlfvxksspfhqzjjkptsfqyfe", "aqzfwkquuylzksromhjcxrsiyrom", "bbrgwzjhwfyfayohzopazyuhbdab", "dynlrnfweqsxyjzaianbyefkgjru", "pazgfeferzxufvifaypnffwajcin", "mhfrdqkbrvpxcjzuabjpclxgxbjo", "xxjwontmjgwjyahbmapdgdgsnswr", "jpoosuhufvynynplbcyquzhvgtba", "stabuyndpsahcekxcnbxdclejiww", "iybrlgbeulamkpuimnmwiqbstyqk", "vhgfmufvvpttgxmmsbufwyxsnalm", "foxdzzccwgozhqkywxmkabmrrnsd", "lsvfgocqaadyjmsepyfgclmpyuzc", "fyrfzhzwpvjjwsikxxhjcldeljmr", "tccabakvnwkxsyqgzpmvskahkrlu", "vhuiqsodmxzjrtmsdpwuniyelxdk"]	[843]	TODO
cobaycosmcnwmtvyqitpotphrpwapuxquiemjzzcwhotxmlhoddysnckelxcznblryhxuywdbpmwqhsjemfndgapsqqwkcwvggnzlrkbsgtczcctrgoamzhurvdvzyiplrmlqghcsxrkakndykncbdikundtwfwnmtnvddahatgsojhfwsljmikfryybkildwouoltmishydvbjlrjlfpnidwrrecrpohgyrcdsrzlafvefneficpvurfolghptffomttuaezshjnbnudxiofdhwlhnrgfmowijkdahwyniiludboycwqexlqsettojnzqaweqxrkdcyevszshbbqwbjqytlkqyvlrlpzrdvpvbckxfoftdnfuwnmffgopxocriwtydwbhlqyfopjgrkibeqgugqgrjxtpggzmnkpykapwbaynurdtecribisblcocmxrssclqnwpdhaoygloimuvzgryswkuqsjdxcbhgjgchpgbfcdzrpfgkxjqskucouuhipwnayqjisbzhrtodjtyxqfekvnwkcgryybufbuuxwlfbtwhgncefgdiuoubgawluqzvclkpnnrlobhtgiijkfibwtrywcjssuruuvgbsebdnimobootwahrkyxudvphfsnbeyenroovasmodbqoyxuabogucnnljeherqvlymhueihpqxpfngrtleemvhxvqfjrnvrpiossizoaoirwfjfoehsonimnzbvveytbncrxfxqwlzrfumwqkqjzpvmcipabewzvoqnnufzevqufhbysmfpjctcfwntvriirwxbdmfkaocxbumxwsdwhbjbqnhmhglfnrdqnqkuyjyshdidhffngfldiurqzrymtqmflgvjlssuhyiwwuenheqqgulajyqtovjjxbyrutoyozpplczhyrxjjrajveqbyobvcsnickacbbjhzrnujmhykqngafxenwylykwsrmufahscfliymlwttacwrpbmhcmmjturhymlvucdrytfjyytzdkqygvchpzmklksqdsmirrsxelvxjuogbjlvmbpjflpoyfytgdpeiyjsyvinkzjtuqrwmcksvxtsvjmxdjlknjqivazdszsieixoycdbwcrlckrvprsrrdsnfkqqhdpqysonhlltmrdecaqyddxpbaudvxdkiykelivxwvzgykitvaqenxcdtkbuchcobjuviknxdvrqtcguygtprmnzgllmrccndigfrobamwaxqkoyfqzhbhjvuqposypxayctfuwgbmecdudjxwxwtvlzhnriwblmgmxofdttravagrizblcvxvonghryaeskfiwikkkvxgozizgyamblpdykaxwsjyjfewexrmwjupzdmalyqvjiryrtbsmbgmgilileowruxgekpiaiqimzrkefoottmdpmfwofrubjznpcuhorqsquqavjrxqkapguutbqzrllvkmfgcmthbauoohxhucqsxxpuwilbitexxreafwtsmrtbozwvfprcddwfyfteyplvcajtmqmizvjryifkhhlrawhuaxtzsgyupnrlfkwxsiyghkfwdfcnaecctvwmxewdxmccgopbeevqmdprjybizzfiyzovsarejpytpzmmdibufooyybrhkhqajjjgarkecpaysjdxihfrmnxcgyeymazczzxgqdimnmdlbmxywmxtsnbbwygquwmjcpdmnfeidkwugdmfrnjiecomttvzkaztbwxgejnkkzbyiakghpfjywmlfaapmgwzoswzsrboqekpdeyzbpusuwsvhkqijkboojxtrwtebychutjknhomdsiaqpmquzyxzvellaevufwyqiafgad	["czcctrgoamzhurvdvzyiplrmlqg", "hcsxrkakndykncbdikundtwfwnm", "tnvddahatgsojhfwsljmikfryyb", "kildwouoltmishydvbjlrjlfpni", "dwrrecrpohgyrcdsrzlafvefnef", "icpvurfolghptffomttuaezshjn", "bnudxiofdhwlhnrgfmowijkdahw", "yniiludboycwqexlqsettojnzqa", "weqxrkdcyevszshbbqwbjqytlkq", "yvlrlpzrdvpvbckxfoftdnfuwnm", "ffgopxocriwtydwbhlqyfopjgrk", "ibeqgugqgrjxtpggzmnkpykapwb", "aynurdtecribisblcocmxrssclq", "nwpdhaoygloimuvzgryswkuqsjd", "xcbhgjgchpgbfcdzrpfgkxjqsku", "couuhipwnayqjisbzhrtodjtyxq", "fekvnwkcgryybufbuuxwlfbtwhg", "ncefgdiuoubgawluqzvclkpnnrl", "obhtgiijkfibwtrywcjssuruuvg", "bsebdnimobootwahrkyxudvphfs", "nbeyenroovasmodbqoyxuaboguc", "nnljeherqvlymhueihpqxpfngrt", "leemvhxvqfjrnvrpiossizoaoir", "wfjfoehsonimnzbvveytbncrxfx", "qwlzrfumwqkqjzpvmcipabewzvo", "qnnufzevqufhbysmfpjctcfwntv", "riirwxbdmfkaocxbumxwsdwhbjb", "qnhmhglfnrdqnqkuyjyshdidhff", "ngfldiurqzrymtqmflgvjlssuhy"]	[107]	TODO
cfrlmkwxvplndehxkxafuhoutsmmhifzxokyuxcqakjmcfqnxbncikhsiewbqraedgvkimuecozxutgzbdxvnqzlaldbimrujivnrxoacjsjjezswactsiypsfxampxmqsrctzfeznmexbrkzljodulqunbtxtkedynztnieuqssfhnsvsjefuglezayettxrzlwycubgmlgkczjxcpqhhwpcdgieakvkvnamkcjpktdzpclssibdhxqnwmxdpbnjaemlnkjbfcopbwrvffmkxabkgjnhslfejmjdcjacpiiojkxfkqkoiwlnwpsgtbftxhelthmpbxvboswahrnbmparsewdrxeprbfxnmugqxsdvvftiinqypchnydhzxcgjcbndmdjuucqqcwfogynkgnwxuigdoucveyenfmkududrdndpfozghuwacbkjmsanhfummvlbqmjgidkrjnbhpjvnsgdxzmgsmobdxeymzyhlhmshwljqavfpydojwwzoeotygogcsvhnhnbicbkjzkmhiuhhdcqxtqcgcpkqfmfhibiotrypyveeqepgivwnbacygsdgbnvvlzxagejohmlqzjxuahpcubgoucwmqstiowexymcuehnithpujshaugnbpjwuzipgtdioionoulpqasblonqsdjuigzpeynpouodenugkwhosdmmhrydvyksodrlfttoyrtvtyyfzuurhvofnddzfbyoyciaebbvfnahkbhdcuveqxcfgrsghhxuzfwwwjbqdprsqoylbrkhkshtjdltnnuynzetzrwxakjbaqdpebmdupcowkotbbqvuaujnciesiokptzndbokxvukgbhzlrpwngblktfinorwrlvteihanagdpvohiaigqtuuluccnayhxrgafvwirnuazsulecuvmirhpaerqgxmbwgwnbhfvuaemrjsauegplvnqhhetxnbkdjbyjwqusaggacqiixycsflbhhnrsvyylesuotwjusliqwhfhocbomgykcsikhmtcwygwpgeiyukcypednohxwuolfktmcldaicdomwkvzeftbzzvtcsitjcfkemzfikxynpatdrpxomtgsuvqfdwjrwhaodveinvlwraaejdlfzubhrhktimifkzuimgjiylhdxvxienxbmtiugxqnyfnunecxfpflthkwgyhffwxmifldqiyzrmktzzbnwbpiizjbhhbfwhmtfhdqbjgjmtticdlaahcddcydepnocxocwtghtlthatwhzsumdhnyemfndnkwgyaioobxwnqzz	["wxakjbaqdpebmdupcowko", "hhxuzfwwwjbqdprsqoylb", "djuucqqcwfogynkgnwxui", "dbokxvukgbhzlrpwngblk", "ouodenugkwhosdmmhrydv", "tfinorwrlvteihanagdpv", "pqasblonqsdjuigzpeynp", "urhvofnddzfbyoyciaebb", "iuhhdcqxtqcgcpkqfmfhi", "afvwirnuazsulecuvmirh", "gnbpjwuzipgtdioionoul", "paerqgxmbwgwnbhfvuaem", "rkhkshtjdltnnuynzetzr", "ygogcsvhnhnbicbkjzkmh", "gdxzmgsmobdxeymzyhlhm", "cygsdgbnvvlzxagejohml", "yksodrlfttoyrtvtyyfzu", "owexymcuehnithpujshau", "mvlbqmjgidkrjnbhpjvns", "tbbqvuaujnciesiokptzn", "jbyjwqusaggacqiixycsf", "pfozghuwacbkjmsanhfum", "gdoucveyenfmkududrdnd", "rjsauegplvnqhhetxnbkd", "shwljqavfpydojwwzoeot", "biotrypyveeqepgivwnba", "ohiaigqtuuluccnayhxrg", "qzjxuahpcubgoucwmqsti", "vfnahkbhdcuveqxcfgrsg"]	[391]	TODO
mlrtsvfmocibjizjgpazpsihdhuskkyvuvaghzivhbobfrspotmxpqtqrlnluneyowgreezxnreucingjndsxapnhsmfhafvjkzvrfpqbntacuoppmhbwegmogfvqihmclrjdtmqmhfufrwermwqeqqqpdezexxyqjneuvtebrmxhnunjwyrxiaeuncmafuhekzaqinzenhcofwccakhfgzllhzxoxqlpdzxuefmvsyykwxnjpmbtyxdhfkrocahrulgagigeigjhjopitjktnfguaxqamsgmkmaftqckbpadxkeitdkynzcjtqrhbuhgeyjlopmlrwpksvcwhnamaarzhzouxddcrfleyhzvymlddttkchkeyhcltgtsmagrywsxyjkyruvxlbbqcstckqtybjsbguornakwgqpxqqlrfymqshoxrnhoqvhbjdoqoyzeomykqltrlhapqheamchtnqxtaskfiwzbnzguobdjuosovtlrigbcaeinqcmwacvjlckkehtmrplfyrpgyrvasuvwcvrunxvmffkhsuccnttwbylevabxbgamcsepvdpwnoefimtxtrmhjlctxmqmolaikwhltucciyqwyvmtfaswcrzzrscejmqonrrcdkhakgnkxvmtsszrctjvnpdipbwsoqrmcnanfdoohonvaahezwrbvcltmywoiolszxzqvrppeiopldnoollyqrolrxrysadjmnerljofxnyqtnpnumktgyvchfckcdlmtfggebpmrnleimromtnitlsgsdzdxssojuegaviionqbnafjzecgfrykzxhfdkvhjgjrzxuratqdzdfqiqwjbptmedhghpjatqisioufjtwbwczfqmbfkhzjktxbxppqzzbgswpzxvemjyzymyfkltoejgwpfdzqvmaxwkfalhpefmezucbfihcxjebeomlyaxhvwssxrlcpfemhypoimggrqqiplnbzwunjifkmgwpkkjbpolztkjacmqalykoajzsxthubmwgjioowvdzqfusfotsoybhnmkptewxerrveue	["cmafuhekzaqinzenhcofwccakhfgz", "keitdkynzcjtqrhbuhgeyjlopmlrw", "hjlctxmqmolaikwhltucciyqwyvmt", "oohonvaahezwrbvcltmywoiolszxz", "vmtsszrctjvnpdipbwsoqrmcnanfd", "aeinqcmwacvjlckkehtmrplfyrpgy", "mnerljofxnyqtnpnumktgyvchfckc", "pksvcwhnamaarzhzouxddcrfleyhz", "taskfiwzbnzguobdjuosovtlrigbc", "rvasuvwcvrunxvmffkhsuccnttwby", "faswcrzzrscejmqonrrcdkhakgnkx", "levabxbgamcsepvdpwnoefimtxtrm", "qvrppeiopldnoollyqrolrxrysadj", "oqoyzeomykqltrlhapqheamchtnqx", "yjkyruvxlbbqcstckqtybjsbguorn", "vymlddttkchkeyhcltgtsmagrywsx", "akwgqpxqqlrfymqshoxrnhoqvhbjd", "zdxssojuegaviionqbnafjzecgfry", "tjktnfguaxqamsgmkmaftqckbpadx", "llhzxoxqlpdzxuefmvsyykwxnjpmb", "dlmtfggebpmrnleimromtnitlsgsd", "tyxdhfkrocahrulgagigeigjhjopi", "kzxhfdkvhjgjrzxuratqdzdfqiqwj"]	[186]	TODO
ojyrgcbkflvttgxzidcmvqkpgclitfetkrramahnhzujclehcdymbnxcoebrsgrmpqrxkbydxatbhoitdrcrlbdturvxpraawukrfpzhzjqrjfovsdofrjxgzxomcarhflbagqiwbdmqgseikxzyggnmopncdptgnzdsnagmeqzlhuejtnsnzqrbvkvmuyidjayxfuaslxmdyhlywmbgjncsaflfirgnugyodahckynpsunuomjbilepxrrmiyiyaroouhdbsimvyrnozxbuqgsmlhposttretqkhzdvnpobygbdowqqehjtqfraxrnmvkxbsbhqsupmddkdnvbpbekpslsnyqetofzstqadpskiyaabuwjfdfqkqhboguolozfvaomzsigdljvhnsyipovyuhvdcvccjafxaapqlzzgvhmgewvlctlvbkjvypfmjuaimjmwotrrzdyualboysohmhzwdluyzdqylzxtswooavgckmcpldcfoyzspfdmuzczozhhkhhzbcyjgwfbnuvkujwzkaljxfewpapnwdxknqfzsaqxdeorachhojowgihalccipbvbnmexrfssszjelenlbnicvntkewoylrjajhtalsrmtazlnxkftvavnhlpytukoxzhpsinlcrytbgnlhopankccnexalenrafyrzuokkykdnhwfhqvcofanstsmoxsnhdleelvygkmzmulvlkfyevuayivodjntyhordetxymgcobfvzatbbbfzlfzwgfinlfgcmgacesaxeyibzefeghubkwyuhimjsxlltjirvlwegjgcaejsuirhdofoigjutmzlygvvbfqdglpsvfynzocvoaoxmhlfyjxyfxlvjvscywglzaaenvrgurooatmbdhjpkdgcmwafjsxritqlvxuacunoaraeuitzbgyoobmjouhwbgqholwmhtmwvrdnwmfyeiyegfbltxebofxrisjpmkedvjexkdetareddgcdojvrliiebalozodjjzucvkcbyjrmwspwtgmloztuqlnuleqcuynapecgbsqkyyqyazgneudwzevmwegtrjalaouxjpemuccdkrevnhxfainvmsydvbcaaokilobhcyoxtiiagdvsaudvefjevlpbtbkkudsvfsixusydyllzbwbuaqkbrbwefrytzdtpyirhuovhtyizqkwkoedrgnqokevcjvesxxoyxrzqtuaqhvvhrsalwkyrttdjvhtwpoxrrgxrjywrlfbvgflrqkeqghbpqzovzwoarxuzxoaqfcqebrqnlwkupzzvobtakvctwejseiumjpheyulkvphlfrkmaprhkdjrjobhxwvuezkrfnlwhdekzowxlcgu	["hqsupmddkdnvbpbekpsl", "tretqkhzdvnpobygbdow", "snyqetofzstqadpskiya", "rmtazlnxkftvavnhlpyt", "fvaomzsigdljvhnsyipo", "vbnmexrfssszjelenlbn", "epxrrmiyiyaroouhdbsi", "yodahckynpsunuomjbil", "zspfdmuzczozhhkhhzbc", "opankccnexalenrafyrz", "xtswooavgckmcpldcfoy", "icvntkewoylrjajhtals", "fmjuaimjmwotrrzdyual", "uokkykdnhwfhqvcofans", "vyuhvdcvccjafxaapqlz", "yjgwfbnuvkujwzkaljxf", "ukoxzhpsinlcrytbgnlh", "orachhojowgihalccipb", "qqehjtqfraxrnmvkxbsb", "zgvhmgewvlctlvbkjvyp", "mvyrnozxbuqgsmlhpost", "lywmbgjncsaflfirgnug", "abuwjfdfqkqhboguoloz", "boysohmhzwdluyzdqylz", "tsmoxsnhdleelvygkmzm", "ewpapnwdxknqfzsaqxde"]	[206]	TODO
dczozwjyzuubsvowzpvqqrtrauaqyvidzzranojhpzqetiysnaddmgbkqhgqzbkawswjthyjmqwgawkmdlchbxyofvmjufbbhfnxunbudfxzrgftbcqdlkrkwwvvwuhvmbpcfkniadldakvsmwnfpqaqopwxbxpgcvjcwchhomnifiofrvfanvbvyinbvxuzszyqycfpsonhsghaodtxjfskiepeotwgpbsrqsjyecokjbbyeixriihfgeezmyrwgqlsivogjgwgmfvxfsmloozzlwxltupykcnzzxtahzphzffzsijtsvpcmmueuteyvizgvrozpvmhgmmlyknnbaeeqxcfujykqznwsxsenrziwzzbqczhfrjquyvojauebtizhpbgxpbdcnvietcbfysmiinkxtwoytdsjgkbfrvdjounjolxpcjnuchzavmxcuyfqjtxodkyplrdhskbbvlazdggjesfqofgdroptmnjyqlsdjqeranojlkgbdtpptztkdksccdciirmkhacimtqysnbrlkjnvhcjyrfoguheeprzyvkumvuriezzresdzrkfzkcrfwibqwwkyofuzmekarqmiihlwdkszmqjgjpnhqchycrzhfazpwintoolsuoucmijksummspmwxiaexvluxoezgbuqqolqhxvbjxvufqvxaropiubvwdtmeejnlqcutzaptpbtmuukbwhgvauuqxcrsykcqinsjmepwdzthmpjtbscctsiuwwtwhxooybdycrwopfbwpsikvumdrdoktapxwvirhytnrieqiccstdmdhchvhbbqsjtxtwuvwemzgxetkkqsizrhmxkoopmbcboefnspfpcbikmkajcvxvkjsvybfmmmvsageifencdniucafrpxiuwokbjkvlfocvjqxxnmlwrkevbbyloidxolcdjzixdhsfiixpybqtrrdllczucfztldvxfepdjvikevuxhluessg	["dggjesfqofgdroptmnjyqlsdjqe", "xpbdcnvietcbfysmiinkxtwoytd", "mkhacimtqysnbrlkjnvhcjyrfog", "tupykcnzzxtahzphzffzsijtsvp", "intoolsuoucmijksummspmwxiae", "btmuukbwhgvauuqxcrsykcqinsj", "zkcrfwibqwwkyofuzmekarqmiih", "cmmueuteyvizgvrozpvmhgmmlyk", "lwdkszmqjgjpnhqchycrzhfazpw", "sjgkbfrvdjounjolxpcjnuchzav", "hsghaodtxjfskiepeotwgpbsrqs", "oybdycrwopfbwpsikvumdrdokta", "jyecokjbbyeixriihfgeezmyrwg", "bbqsjtxtwuvwemzgxetkkqsizrh", "xaropiubvwdtmeejnlqcutzaptp", "vxvkjsvybfmmmvsageifencdniu", "ranojlkgbdtpptztkdksccdciir", "qlsivogjgwgmfvxfsmloozzlwxl", "nnbaeeqxcfujykqznwsxsenrziw", "mxkoopmbcboefnspfpcbikmkajc", "pxwvirhytnrieqiccstdmdhchvh", "rvfanvbvyinbvxuzszyqycfpson", "mxcuyfqjtxodkyplrdhskbbvlaz", "uheeprzyvkumvuriezzresdzrkf", "mepwdzthmpjtbscctsiuwwtwhxo", "zzbqczhfrjquyvojauebtizhpbg", "xvluxoezgbuqqolqhxvbjxvufqv"]	[176]	TODO
ueftwvmvoldeizzkpvxqlxjslywmalltubiaedaazmxvcfevfxgefppbpcaydigxwufdrkopbsqpeqqgkrwqvrwqgenfgajnwucmsnwpvlzmetdbaqdrepvwpnsldrvfylgcysvvyxbeokmufvtqnduhcyqhrfjzvfqvogvoeohzmlgwrnujceotkdmxcvfupaudbsybihlwnmfkgmyoobehkoncmoywslqnypifdbsrzbxkzxoslhfrczwnlglyhvchqhdsxxjnsapwpghevjrlmhyuvrshrklbozusfsbbifdrrbrxkwioeigvehhsofpayodnftilspijqeaijetywnyjgoltwkhimvxdyvosnylaeqyygttulglojwvggauyadizdyictbqjwqduuqvtssvcabzbcgkwngvlqqjudnlpahogyzqrqgtyjevxwkbriegrwiyqhxanucasfydagqafwayuakyebqctcruffwmhzsqtcnhozsgvdgpbiuowzpifvoxivuyzypocorpldlspbvgtpkpwfalpuwrnzatzjkqexzuoqkdgenppszconjgeqeqklshactldmjkwjwpyropjrbejkdvqyffxotfqwvsktsggzlgqurnycfjccjbcpwgdfrsrxjlzroeqnwamhjeqpybvtzcuvhaqfgbyiszmfagmbbzaexypzbqoxmfaxjyvivjrnhsmcazucnwctgvmdgaotjcztchuuoyerszwinamebfjdibilxtzarcbtiqrtpcheqydoakarpzzzakiqdyymcbemdrklthsphrdsxbtyrbofeyrjtabxlmuhncflibvjudrwyhiaxykrtxzwqlbesfavejcdecinxexxabqpbfvyvagiqjgmuvofkpcvbmushjgsvsebmeemxwdygpmhqajpyaqbszuqbxmbwzzjxaefmyfdpwbhmktvxubgiqstefvttzdontdqdunlaiqcfucvepdgazqxyqowjykuttmgrgbqlgbbapbxzympzwtocbvlbkykdeihwwtznvxjqchjrlcqordqudmndepioajkbdhijspnktsxzkesxtmjgzufxbasxocsvpojmglbqysjjuracnootfgowvpbzbfzqwotpfyznlhckfwloyuefxhrltufjbjfyecsqcwatyidnnogsgwmeksctemdhvcbmyftllmzxjejchfyyleecpsrifotifywfnivvwzagxomptmszopgdbeuiarsjrzskknygganeugfrtoqbwljtucfgtbiorohxghmssqpkralhsezzshoefwwctcqhqtplviynlpngjyvrvxqssdpbplpujxgnmxkhkkdrproszojzcnwkrcmvdquikxaopzcfahkynhlwrabtdydzxjzmfwwqbewgrhrillpkpedkatjotgrzfqlxuoknagrikqsceelqeoflbunvxkhyppxbdzioevyvgllwstcpbmkoqpmkulyoezxtneb	["ijspnktsxzkesxtmjgzufxb", "ljtucfgtbiorohxghmssqpk", "fyecsqcwatyidnnogsgwmek", "lviynlpngjyvrvxqssdpbpl", "nootfgowvpbzbfzqwotpfyz", "rlcqordqudmndepioajkbdh", "grhrillpkpedkatjotgrzfq", "nlhckfwloyuefxhrltufjbj", "unvxkhyppxbdzioevyvgllw", "iqstefvttzdontdqdunlaiq", "vwzagxomptmszopgdbeuiar", "bvlbkykdeihwwtznvxjqchj", "sjrzskknygganeugfrtoqbw", "lxuoknagrikqsceelqeoflb", "sctemdhvcbmyftllmzxjejc", "nhlwrabtdydzxjzmfwwqbew", "ralhsezzshoefwwctcqhqtp", "dygpmhqajpyaqbszuqbxmbw", "nwkrcmvdquikxaopzcfahky", "asxocsvpojmglbqysjjurac", "fkpcvbmushjgsvsebmeemxw", "cfucvepdgazqxyqowjykutt", "hfyyleecpsrifotifywfniv", "zzjxaefmyfdpwbhmktvxubg", "mgrgbqlgbbapbxzympzwtoc", "pujxgnmxkhkkdrproszojzc"]	[904]	TODO
tkgovemyywvmoyleiabltnntwiyxhpdtmuamovucmbmilvlhzmbbackvinxjklvxqtcvzuvqveetgvamemofmwjxlppdrdlaslsrjzsmmfyzwzysjhpbjfjpyqhaylnzmfebdipwuvvahjgqjuauxhetqkejcpynvbvyzhnwcgvharypcoeltzgpfhfjomldplyalucsdvxsxtaaxqeehpnqpgnszqssozguwgjmbpvjlzpmhkspiqyqarpulxwuetcaijyzqjyocvfcnppxdvtlbljwwusawsubcxnqzrczbfzccsavtutnqcluruizjtnwnoejuecyboylbotewbpubxpjyqvkogbincuoguhymytdprefqmatpbcdsvklrhphckzgoslioefscldjdlchwchcqwlswxawcgohmgffdnddvcivxiddmpdeiaqgnzounantibpjvhivpufbsqrvvbewkxssgbidmxsrwazwbqnrlrqnssntnpcsbzryutqteonagwvfneacvpnsaogyzbpnnerpilllryevkgwahdthhfsavitotsjiizquezjddlymfkyynoynvzyyyhholjfddmnuqbgyibuucbgnelorehabhlgbolrpdckfxomhgzkgnhdpbznysyllsfmxopgpdpcbznuwjptbzaengpgwvfczkkgjmcfwdfzsbkctitnvrpgyocepjgtrowzfmdnwfwysxybhpvdghrbtgyatrunnawbcmvkumnwcrphehdppgrsybehjhmlabitokqnsbasybsbbarrivinaswplbrejzjqfkghcjlyoeaujicekitqhqcltbqdumyasxxapmoasrfhzinfeiiekmfjdwqerwykptvsyhgpusokdiunrtpdfcfywwbpbsjuumjrmanseifkrxzfulqbsklclmhicjaubhyoarlyozgnnnxhqzgoqiptgzybytvltqgexfbucfpurgnxkhrufemsinmnfkcpgbnjtdstqailiakbxovskkrxszcdichzrmcnwtfuuufafbwsenuzscerperfuudyzcuftxbiysdimmdtlgburyvggbldqbvhlgqejaskgaxpdbsaqnfsujihoodhgdhfrvltznqmqsffkdormywtibaygayyldmwcdqtnwfbynsembvxlnndhqygzfrrqopfodhiiyznextzwpeciphicyspikgmikuynunaxwyqphhfteiywfmkiqjggtpsqkpbpwwgrmlgmbsyddimfxluahdwlocowpniilaovekmcfuvqlkwkvaqvsnarnbpkdylaogtwhfkyakfetgszwozdjbbliuvjxahu	["zrmcnwtfuuufafbwsenuzscerper", "engpgwvfczkkgjmcfwdfzsbkctit", "sujihoodhgdhfrvltznqmqsffkdo", "rmywtibaygayyldmwcdqtnwfbyns", "holjfddmnuqbgyibuucbgneloreh", "fulqbsklclmhicjaubhyoarlyozg", "nsbasybsbbarrivinaswplbrejzj", "nvrpgyocepjgtrowzfmdnwfwysxy", "ucfpurgnxkhrufemsinmnfkcpgbn", "axwyqphhfteiywfmkiqjggtpsqkp", "nnnxhqzgoqiptgzybytvltqgexfb", "nextzwpeciphicyspikgmikuynun", "srwazwbqnrlrqnssntnpcsbzryut", "embvxlnndhqygzfrrqopfodhiiyz", "rpilllryevkgwahdthhfsavitots", "fuudyzcuftxbiysdimmdtlgburyv", "abhlgbolrpdckfxomhgzkgnhdpbz", "bhpvdghrbtgyatrunnawbcmvkumn", "nysyllsfmxopgpdpcbznuwjptbza", "qteonagwvfneacvpnsaogyzbpnne", "dumyasxxapmoasrfhzinfeiiekmf", "jiizquezjddlymfkyynoynvzyyyh", "wcrphehdppgrsybehjhmlabitokq", "qfkghcjlyoeaujicekitqhqcltbq", "ggbldqbvhlgqejaskgaxpdbsaqnf", "dfcfywwbpbsjuumjrmanseifkrxz", "jtdstqailiakbxovskkrxszcdich", "jdwqerwykptvsyhgpusokdiunrtp"]	[486]	TODO
bqabespaixficemoonewvwvfunsldiawuyvnujvtqduxejfcoictihoqiiziwdkcczuomhyghtmgubhsotzvmpnqsrusofxsiojfwwqhtvjvmwwsqfbbvgswfanhgucoldylwupfhsstnnzqtfnddlwzbnaxmjqakxwoippnpcfyuixbuabxbbnuaviizprujtlvxcaeenwwhmafiunrhnwoaiallsxiearsilkaqjmmfhgcfbnxvgscjvmiwjwzzzemevyhrtrkmflwssxbnayourvpxvbnszxkqrdoyzbejwzkdwenawjjtrswlgnltaprdyccbygzhtmhtliwlweztkzrozkydsvlphuhdyxhvhlnucgmyrdxmelsyiyphkufnjundiyadmxxeckbnkuumxuerrgbapdxsxadzjaelpsjrkezwngmxcndnwvmpghpuzpnckrxletovipahyieqhofizwstjcbmrgeafqbhrtevbljopuyllayeuyhszjxyrqejrqgcjrkrjgmnczsmdcdxzybiwudtvoulyymwbtrzlnturekzwjsfdbuwhxqelvjcofprobhjbaqqsyondofdrvdacfsunkrjcwcnxtopwymnqldqhzfaqzymjuooqmmxpjmjplshmvyvgpnigqenkgxaylqubgihrqgvrdjnanxxcmfpgyyekofdhzxetfvkoxecxaupvjrhfhsqsuihnchiwzbljmpvhnhzxqbppqfactgxgozwdxiwdrlisuzycxbjbmsivtzhkqtehhzprmhrscxloscwxhjutkqsmkyqhvklrxuyizgpbmcfmefhvcfsqelvxcgeijixfqocjetedgyazarqjifhbzrugzwomjfbypidnmenpvmgpsndhqhojbnrfnmvkwuspfsybephtoobkebwkjegeofkjwzvwgvhsbqnzxkhfbjpzzyxmbpnrvjummimpozuzomyftdrsjbrmisoecjukbetyvbtzlbihhnmmsnakgqqjfymawezbmkjpoyakiznnrumemyxuugsbhacifweweuiurzqxifxmgkdpsaemxjczzrmjtsepaarsljahchrhdofsqyabwjqfugcgwgimxxxatyovscjdsyqqqgssezzslbwlvkxhzyojlarfjmzheockrmkuwxmdpusofbwjiobpqlxpbslfixyxksikaqikbpadhajntryekonrjdkvxnczlsxbztzfalfrgcrlgvketjupisirlqpqfrsiiocribyoighjudawkjhnhdtpqaaosavytkvurklvrcrdmlwqihsnpecmlosftwajkplmlfyobgkhnkmknxiyqsrfijjurfqmvtkgjsrewavbfioqraxogdpooslcrrjlhvsnbjrvtqukplywwrovewzusjrecxiqhylkdketysctlzldyhbbjfhkhbatpzjfbycvnwdiwuxlgglkodrvqbemmlgzoritgldbnsjnmlspntnjzetoqiqgcdtnoctzmtfxzhawugymspsrgzmlavwogtjevpcyvbrsoldlncxltakflqrvdrznimozznasaqftrzztbnrqvuzgbhmvadbeufyntjdnyztvhhloiekrsxfgegafnpicvspdhudswtgkmnbzoopjfvzialcmxqjyzdpxupvubmfcxnwsehkkexnsbcvpxtfntxagjpyzoubsmbflophxohbtqubwvdnlvxntoikmtoxgtgnchhewlfttastulfxgnuqetcniwaktmibrnft	["ugymspsrgzmlavwogtjevpcyvb", "rlgvketjupisirlqpqfrsiiocr", "egafnpicvspdhudswtgkmnbzoo", "ibyoighjudawkjhnhdtpqaaosa", "vytkvurklvrcrdmlwqihsnpecm", "wgimxxxatyovscjdsyqqqgssez", "znasaqftrzztbnrqvuzgbhmvad", "losftwajkplmlfyobgkhnkmknx", "lfixyxksikaqikbpadhajntrye", "vjummimpozuzomyftdrsjbrmis", "hylkdketysctlzldyhbbjfhkhb", "rsoldlncxltakflqrvdrznimoz", "memyxuugsbhacifweweuiurzqx", "rmkuwxmdpusofbwjiobpqlxpbs", "fioqraxogdpooslcrrjlhvsnbj", "rvtqukplywwrovewzusjrecxiq", "rsljahchrhdofsqyabwjqfugcg", "njzetoqiqgcdtnoctzmtfxzhaw", "beufyntjdnyztvhhloiekrsxfg", "konrjdkvxnczlsxbztzfalfrgc", "gqqjfymawezbmkjpoyakiznnru", "zslbwlvkxhzyojlarfjmzheock", "xnwsehkkexnsbcvpxtfntxagjp", "oecjukbetyvbtzlbihhnmmsnak", "ifxmgkdpsaemxjczzrmjtsepaa", "atpzjfbycvnwdiwuxlgglkodrv", "iyqsrfijjurfqmvtkgjsrewavb", "qbemmlgzoritgldbnsjnmlspnt", "pjfvzialcmxqjyzdpxupvubmfc"]	[974]	TODO
rpanvqybedcafuzrgwmuhcxpoklzhrgnaspinpqssgixrsodwqklzjoyocjdnlehckzyzmwgynnlkxvflpwxnmkicoyyrzxiqqamangvhvrbhekmfixdiuygebzlunbbfowlfzuywfepnvldpwnjzvlroxqedszmqucddfhlzxsohrrwjyupvfoajkmffgfhdsovxruasgicpwcnbfrmreatvizpvamzkqwzzuwedapvqokvhsvqgxrwuthyjhzmjjuptzfosbniwcxtrdrdwilzzvzhrhdfaxbjvngqqoxvjgctxkmtdcqtjyyftljjydpsbinsfcaopbhyalkgqpkgpniygwcucszpxoduzgbijfabwhzvsomlxipaaqyeizfrewtrekyhuotjrazufziuveykwyqirdmlltaxzqwhnxnwrojmywjszjkzdlvnvvgjhvqfivghpohvqaqqagqwlleaoyhimfsdtayzigkuweyamokampadmozqsntvrtjqjjbwcazdmueoevkgrdhuribjdxeibdtlfkhmdkrdspjyrmzkdfvkrmsnfghkpwgbixbejdpesqurnlsebvqlaaecvxbrfuhrappwsmzvalztobismtlnctgueutahygzpxjlxlrdohsqpknhezuhadkoiuizuvlqhkzyehdwocqlmxsbnzxtkrdrxbhomvklxqlirvnuzpfggfjoaqddbannoexobzjfynjrxmpnteqfnyxpsssynknkvjfolvtlxvagquodhkyeaxikxikcrhbzikeghkxbpcucfbiyniztcsumxvjsjdgywrztsnxhgqvnvpqfjyzkmdxxroxfjnfuwaqmxdlnuupgqrqgrmqrccmfjpjpzoqeixbuwtmjvlhiauvbuflfwcjuotqydkeyzrcjocxaqwlxjuipobevplecssdctxlasnbogkfsiyhmrgpzufbibzgmetcneapbtfskuxfsxysmgdzryubgpeyikhlvjmoatvhapynygfyzyzxypigyouixnedmbjafeulfrznlvqkvbjsfsgivdcdbxawfbnjjwnodokaaphktnkginatbzmzqiuhnwnwwpschfezbksictvguiicsfpidagbnogidbbqkjyqsshrpcdiwgboqfteckzbpdnsloaegqswaldjnqwqsbkinjqboyglholoqebswymvldezzgmbuiqmskbvkurzbiyosevmevatuoadbqpctjclodrxxxqncqkuwtegcwifshymrxrqqfjnbtdieedhywnwpmzssvpqcfvfeghyaiqozexcdsvhwxptpklhpwuqxypizsayfxoviluglbfhigmendkjcvbmmtigphgbwbwntzswrplmxdedqafgingfuaaqjmsuboyxesxldyhydkdupmruihomufqtfnakxvranvjesierdppst	["sbkinjqboyglholoqebswymvldez", "hadkoiuizuvlqhkzyehdwocqlmxs", "ggfjoaqddbannoexobzjfynjrxmp", "amokampadmozqsntvrtjqjjbwcaz", "vplecssdctxlasnbogkfsiyhmrgp", "jwnodokaaphktnkginatbzmzqiuh", "mgdzryubgpeyikhlvjmoatvhapyn", "uwaqmxdlnuupgqrqgrmqrccmfjpj", "ygfyzyzxypigyouixnedmbjafeul", "ueutahygzpxjlxlrdohsqpknhezu", "pzoqeixbuwtmjvlhiauvbuflfwcj", "uoadbqpctjclodrxxxqncqkuwteg", "qfteckzbpdnsloaegqswaldjnqwq", "frznlvqkvbjsfsgivdcdbxawfbnj", "bpcucfbiyniztcsumxvjsjdgywrz", "gquodhkyeaxikxikcrhbzikeghkx", "bnzxtkrdrxbhomvklxqlirvnuzpf", "nteqfnyxpsssynknkvjfolvtlxva", "mdkrdspjyrmzkdfvkrmsnfghkpwg", "uotqydkeyzrcjocxaqwlxjuipobe", "tsnxhgqvnvpqfjyzkmdxxroxfjnf", "bixbejdpesqurnlsebvqlaaecvxb", "nwnwwpschfezbksictvguiicsfpi", "zgmbuiqmskbvkurzbiyosevmevat", "dmueoevkgrdhuribjdxeibdtlfkh", "dagbnogidbbqkjyqsshrpcdiwgbo", "rfuhrappwsmzvalztobismtlnctg", "zufbibzgmetcneapbtfskuxfsxys"]	[495]	TODO
iooxnfscaueluhvvqzksfmbvsmopnrlleexvomzecyetwtmenvubhmpamwzwnnnvvocmrmehickdjvsoxqxnjqgjskrhexcavpaktzyjmuvywlfdfcbjnmghqygoelsapedwhxohpmbclwcfdlxndttkviltisofxtzbkgragchgmsnfsrbeeuttoosvggjoyacuuyydpwupimpfripwpbcwckttzmeldkugusuvillsdpoaknuaqtnglxizikbchltesxrkyrrhezqtjzeyghtczhmdcwcwwjxiwhurkhvplhnklhucbhovbtvlgbnftrggkryqvulkpnvstekidabnsschxdiqtterelftcfljwvacoloptxywkpacshwbfhgpjnzwzzrjpsznscxwsehocqhfutebfqihslaxbogibklhbjahrjkycxxtqfuhvpnrpgvyhseorwkgodsehrmzvcniuazwzquieesrcisxapppongdxgebrqrymglzeufxfthnqatksztbkxncrjlexrmxcdmfcqxnlzmfnrjygfoziikjbflradvhlhyxieohxritonfybaaahlvpdqwlkovmmgcxjhbnqaiaggvmimdwmkxfjrdiskusbtmtkzyjbzkmkyduilkikiciyisdnjpqfsaqcvclrbaltluvrnwdrfxjifhlhlmyzackqoddilavrcioaltolkdiqvyuvierxqluldcyaiutprzetuupwgvosnvrtasqmenlzdybipivwftcnxjkpiautqxsmktkpcfxxxrpfyawyefodjlozavnmbjkzdqxuvstgbbgacqhqhkvndaklqwaepdioveyxifpdwyafgqvovyhqvxqidmmomizvfrngaxgbwibqgsazfjtywaznazidmlkfowwpafybctptbsuwrjauknmfvxdvxqykoraprvixmvqzrwjorkhlzhfozklljykfjdrqvjchiwrhvqmmhhmrnkzqvzkcavukvhvxnzbajcqcnjctguednyvpdhqluwdwajacanykdggbzaxkxdqayyzhboqdivbhunsxklgfcawkravvayqhwtgqwevmaohciasuajgivqcmfbvlrivuvszocroyzfsdmgcaelxtfstkyfkjcxswfcuuhyorxgaxdyyzyzcxxyueywlplzcdmtghfxvutfoocqceprmkkupiksvmxnfycnwnosawppikrttbztssxnqijyugrutjmcsokeuocrljzpthnnlamqhhcssjqngqavlmruoxhonrwckvdkmmyxhemlljncygwygnsxtlkirzpmopkopufffqffybczmfaubwpibrscbgixjnqmahfmuvfssn	["qaiaggvmimdwmkxfjrdisk", "usbtmtkzyjbzkmkyduilki", "oqdivbhunsxklgfcawkrav", "canykdggbzaxkxdqayyzhb", "tqxsmktkpcfxxxrpfyawye", "drqvjchiwrhvqmmhhmrnkz", "xxyueywlplzcdmtghfxvut", "xswfcuuhyorxgaxdyyzyzc", "ibqgsazfjtywaznazidmlk", "nlzdybipivwftcnxjkpiau", "vayqhwtgqwevmaohciasua", "diqvyuvierxqluldcyaiut", "nmfvxdvxqykoraprvixmvq", "jgivqcmfbvlrivuvszocro", "fowwpafybctptbsuwrjauk", "kiciyisdnjpqfsaqcvclrb", "zackqoddilavrcioaltolk", "dioveyxifpdwyafgqvovyh", "altluvrnwdrfxjifhlhlmy", "yzfsdmgcaelxtfstkyfkjc", "jctguednyvpdhqluwdwaja", "przetuupwgvosnvrtasqme", "zrwjorkhlzhfozklljykfj", "qvzkcavukvhvxnzbajcqcn", "aahlvpdqwlkovmmgcxjhbn", "fodjlozavnmbjkzdqxuvst", "qvxqidmmomizvfrngaxgbw", "gbbgacqhqhkvndaklqwaep"]	[590]	TODO
mppnhaycbrznuwxjmnjhmijiqsestcdagblsyydvqdfayrnnyxyrlucbyrlokxmxwmohnigxzjqqbxdgtfktyvqviyiecuwuvmifdrhddjckcrxikrvpfceypzigvxrpjsfktcnqlmhslxqkisknendeolpcxrcsaqdcmcmpizffetezfoyljgedgbrhxskypnmmmtavadrqevypgeppljeggxslrxjrfqzvhkptqrhiibiycvrcadbdmzuzdthhhhgrtulrfhsnxqxhwvkfzohanftgvpguzngmsfzxksfollyavpdvhijqnoafhvrrgkzedzkoceqkbditdhbuggkkkixwzimfjthkawtiyrquitxztwiubjjotczaytuicijvxyzgbjotyumojxgcktwggsvtfzvjgswzzaujrsoeyhdidlqqprwgtqddqmsacvagjxpdrlkeonzfqytqqfarmbgojqlzwaflyiuefqskvfdwmqlopmqayaluozvttnplsddjsrrqwvzcwzasmoinlicruylbepxldaeyzuxahddavbieurvufogregvsgtwhkyqccsvsoziiermtnebwuzptuxfnbeyrixkjnjpqjiwsfkutomsftcidonfxgavrjjexfefzmvfgjyuxnnrlafvparxxzpvyjtgpyjmoagwrtqdlvghjngjhcsdffpmpwvthaansdzkjyqbkadlhlerkovesxjsqaijgevjturrsxvdnmujmpbflthwbbvirrmkudrbpyvfgpokaszwcevcyuugtholorasvmlxrvhfvqdjzvofagerotchmthrzpwdmkmljpssyohnfowuwoimhjlpnorohtfmcummvgckwwmxzktspvczafzhkhqaztsgxcipqjcrhfdzeecemxxsrewwvlgdmerjlfjbzpxzfmpzqcxyowpnyslcsgnclyllmjxaywtasttpubnsrrtjwtliuyngxngevzqkwruvpdvuwfqtwrnizqoidermgkyhkukufbhiaurgnbvpvsudpslxhrjsaisiruosmnbssxbpwwpyidsiyspqtqzftkqpqbfoimmbejqrooecfonwwnrsxhxywgorzwjgcytrvnnijgypcdwuitylpiysyeanoratjcpwwobosgodzmpgsngsskvznjyjxlokfouvqaczdkxvfehxusrjuuqctdlqdopojdgujyvspaqfqjzkholusbqukykqxcbchzoxqcnqixawktuwhgjsmvyskpmofjkkqtodgjkrcitxvbnvzvnalegkevtzagsrumghnboamhjedvaelhqlxaawbkaoevytetziondlncegoylyqqyclrdbabuqtkoqgrwwjywupnnhdobcegxdcmaunjklrtqczlvbqbanvzqznicirhzamabhnrhqpbzzxdjfsnkqrhqqgmtkpwuacapazlhpbrmsvyeqeridywst	["ppljeggxslrxjrfqzvhkptqr", "gojqlzwaflyiuefqskvfdwmq", "rhxskypnmmmtavadrqevypge", "dcmcmpizffetezfoyljgedgb", "dvhijqnoafhvrrgkzedzkoce", "tgvpguzngmsfzxksfollyavp", "oeyhdidlqqprwgtqddqmsacv", "qkbditdhbuggkkkixwzimfjt", "iecuwuvmifdrhddjckcrxikr", "zaytuicijvxyzgbjotyumojx", "grtulrfhsnxqxhwvkfzohanf", "ohnigxzjqqbxdgtfktyvqviy", "agjxpdrlkeonzfqytqqfarmb", "fayrnnyxyrlucbyrlokxmxwm", "rqwvzcwzasmoinlicruylbep", "hkawtiyrquitxztwiubjjotc", "mtnebwuzptuxfnbeyrixkjnj", "hslxqkisknendeolpcxrcsaq", "gcktwggsvtfzvjgswzzaujrs", "jhmijiqsestcdagblsyydvqd", "vpfceypzigvxrpjsfktcnqlm", "xldaeyzuxahddavbieurvufo", "gregvsgtwhkyqccsvsoziier", "lopmqayaluozvttnplsddjsr", "hiibiycvrcadbdmzuzdthhhh"]	[18]	TODO
igyychreowfqjvfxcolopyvkqjmnyuqnmorlcnankblsedixbdtzuasvqqytqokdsyubueylfbnbhgkqcmnolzgwujzkyshrrrvdoquyespcocfnxzwxqntkmutjstazbjmjrodpbkdjgmgmbnaofngqdrrabobelfyhvupelvyfszwrcdwkfupmdqkyftgslffbzlgjqjexpjnicbxqkodhfrlpwzytonahuksqnkbqiyhtplmeetekwacgbgrgmmzmzesmarsoldjonqrpzwcnrxevzoiknogadtkowuitdmjssaytrgqdaslqbdplwhzlwdmzfpxmdfbztwhvuqlclyfbnyqkyuqefdyoklxusvzlcgwortrrejypdoanpsplzemscaswstwbxajurzdtqxjlowxshpngneopxyzfcrxecgepbbsmqcgzsaeixweiidkfxscejoukltaqgwiddpczrrodbrjxsijfmvvvavpgcrrkqjxlhezuoydgucmsqqedoghhipjqbmoeqpmwibbqpyipzpyngcshkshrlzvtbadmxtidgllrkdqsvwjideiuvnnwahgszpbgslcplmqqwahmdswzvkgwuezamvtbggnoztssdluvaufpjxhnkgbkydjjlxufaikkvnnlnnvonndarrohcgbzcdwciwqplpabqcwywmakpejtwkpdiacbpdsvlxgypktggjsuvphmisrkrqrjdenqqjcwjlohvigietfgjivmalgetaykxxewznmwrxwhsuivtaslwrmdhvqoiomdpryudjwfzgipmzgnktrowcwtfmfcxqpwbcwhkaiikmbjksmqkoferlsgzmyadedhxyylfdritymmdhixcaopabxvflfaamzcjjgtacvuzseodbpwidjthfcidbtpixrozcivhhvgsgladcrgpzxptmbkfaeemodbrjerjgacvjylkxfcajrnkkudjeqqrkeiinfmetljukjklpaglmmvzmxphqgneyfvhosejskjunixbozqnvcajonzfmakzqpzjkhoublnlritqcmvzlfqmzubvawinfomdcxsjyafutxqnaoegvjldjtxbgslqbgkzadwjphgslrggwhqmsptozpjwysgttjuucwgrwqzokwlctqhljtcwzbgiuvytrybptntjkhhqqksaesjlkbodpxzpvizldrebdsnuiubhhuzespanmrfuutwyyxyrngyztxayxsvlsnmcqlpdhksreylghbeuigzkzkwzucjftqqatjetivwbbwswcqbwrioaxjvxkrscyhyojcfofhjxpcqdicvftaqpqcoppyreyurdczwvzryxetnvnxnvmvgszukxyheqhtlcuwgaqjgjloruedyhxffgzrgfxhuutlowtlraieqnrkitruonzyctllhxkhrmhpioefxwbbkytxcwnnyaxzdhsrlnuhphtvodnpylaqbrbjvkgtfzumjscfgojxolkdulvhystwfchujjbptbuxrpjcsomvmzxesbodhfviqqjnunwqkvbhmumtwhaijgvoszqdooagjwmgkidqhywmhnnpuoyguthsutzoiqlemayfprxexqxhvdpywmfwdfydhjvnxbqeitbbqvzwcgwzojjfvexubhswsxkfkpbrfpyugfbhqmzfvpotiotlohtbxoxvskkmabekujkqqihcbpihsklbbtoqfppmaclyfcqfbpuebuxppfevrcpyndtakjysvknujyzrezojzthhyevxxclippoalaqwsywpvxtjgftwhowyrolduvjwalijzyupvbiovyldsovdnoufnlgnvtkiexellepwfkjuqsslbxulpnswnokyfwnytpboiajcfpohyblwvloanvriaxnwtiefkzyrbfexkdxwyyatkunlyfdjsshkgmdfknjozyesxohkazofzqdshgcsocnuxzfvatmvchxcexgxjxspqmyqvahaynakabqygdtldwmqtkqlylptamgihgpvmrqyycvjpmsvitekejvafguwlmlkycwztgfcluycedjqkyegdgkgblnqgupsofpiqlbphpievespgvhoikxxbnbinzmttrlautnhjzorkbtftwvvckkjlomrhxqtnwdnjjdtpwbaagqnnoywgbhggcajmiuekspicvvrmeehxsurblqiqbensumtiesnqyfiwrsntqupxdbqnexvfcymczdblaktjrvuinikyjcyastckpfrisptpqgcdinczlccrqglxykgdclhdinjmwuuggcotpnhotcwgyozvcvxubhdxneabeaihxbotkofodllxejkxdvxlvdyytjpsbydqpvzczouemxorjguafugusfxlptnacjdrretcnqxpvotrxbesbxfujjlylrfazmecxshdhlvqeekefaqrgurtguojdkwezixjclcaljicyrrnmydlyfefznpmxfugcuwhxsahotmawccszwnjxwpjkivyckfulxryiekbizslvvisezceudyljwvkoukmxhjsciuqcfwguyoefnnfsrfovumzuzkrjnfkggelpffwiyfmumbjcxkfxzorwgiuemkhvaymqnilrazrkdgjdfeipdzzccanljubbyfmraznkqsqyonrkpjcbpyjnfgreclfzdbmtneeybsvgjkfxdvqqtryhehmxkbgupktbzdpdgapqjkwctmjzedjurvrhoaxdswytkekfxahjzqbhdufqfevgzkzhzgdeursltrdteilkyqkxknqrwcaravxqdijfjedhtgodeermsycuhfdqbobsakloxfyjbrjmakwxzqceoxtpsbjugusvliaxmfzfgpqvagkqdzjwgxfokewityupdaotqyhnmthkrkpidxhohidkvvucqnrletesccghijkzdeozcclcbnzeyartcnorvrggpqjvninjwtwsstqhqnetoojnqliehphtjsammovdfcamnigkfheyovxjbsyvvvadrypcagwtliiuzplwoaenjomubjvpdibfuabckcsbtgkxhqqonsbgyicwofjwenhecbnjjjnutlrtpbjvuusyfwovuloexonmgivqmxqdykvoodzpdpemjdzjuhyxchcldgwtzavfjtvybiehvngdfwczpzzdzynmjvipfhheoqmjxujbdtymzabxqdduujojrqxjtllfwzptmymocgrybvhehdouaigcyakogvyrsmbtgsfltjyadvxrlpdjbpkwxwsgedcqtszxctldlbprpoiciaklxwwuayglnltqduqpbwvtcgbruupfcaseryemkxmlydpxsgwhuewcxcpxoisupceqgdfinwdhyqurnbuifbbsszfvpeyfuahmefwwlvwbobltcxlkqtuxugkwyqlhihgbiuaivdxglyrgkufeqgebqaconcpfahrtreykwyfoqaxtafsspqhjscljhctzewrojlmhbqcoimitwgkzikpgzpqfdawtivfmwqgeckdqzjznqfahrngmbnqyompqsldhpcmrgobvliyqazqecnxsfwivikegqqgzskmtmjammzslwladrgmjnpifcbwimroqhugmgkyyidblrdnnpecwitutgwlyvmpveufyliqrzmumwdeztrxlwrpnkcxphtamqqapynbftbwgyjwpzqonydiwtsztlqdpapjgqupakjkqtoghzluinjkvoicchtdmsavxcmmzvfnavmgsamgoqjgjmkkmehykgqykiashtjgeqvqisdbuaiglrigwnjoenamfvtfehwnqmyxbrqbchngxzvqaifufbmoedvndofyrikvfppqpbdtrugcipcczxuhnynfcgioprzkqhpjbklkkfgrhlpfypfuegzuvcogphjjhyoqwceovypqbfrwkjbmtnectrhfrseuriqkqjgcdrjhjzwswatacsydfvgjxhgdnrhvzggeatmvunxwewrryuiivpeytxrquxpmahultowtqqjjmmggmppjjidldipfsfwtiwpvjfcuuyjejtyqfexewsclgrdwaygophmlixlfkibnkwydiyqldivcjxswkozmckaqvjhtmbvzcweqpjtqmcfkccoguyypbfjoezfrdnmtbrzazunypgwrljcxigoxphpszlfmubdkvofdozxdbqfqxbqsnzjbfyhtvfivujpvkkxcfuwrqhvvbcrlvzqdswkrlxlxjcviabqqvaboaeasrcnyyvrreyiehrcstfmunivhteoudxsiegngsdmknpzubvjgdvgjusstqktkvlnjfiwoaigokwtoellqbzrvezazidshujzgorlhjzcirnborqgvdatqbrnlfzlfwjpszospywvxkpthgxkommjiomdvbddeaqvbguajbfjplleghalgyftcqkjehanmilipltltxfjyslsdjscsmiqsurkuelmwvwgbzfagobsbteyhqassplmwufwesssuytbfhspcxlspadpielmiyhllfwacywcqjjxseowomhslrkdwqpltelevohfawvnxddfqqhfshcdngfkdlvbmwjssjephgvlcliswimlixnfzadmzhjkponkkpakufkcixwlssvgihqpmkukbgtglqfvgtqgxelsownbyxinlhwayvspdludwfxnxwehimsqnjeufvnfvvtttyzbkzhewhpqwdqytltqifvmnywyqgezjlidsnthnjtvczqnsaycttlvetwsrftgdycahimrmdlhcpnbrxsvpionyjahpnjvhkjhrqrckhcgppswtcmswrapgyphhhbhbuyvvhgwylroofsiqqcmbydnqqdtbyochcgqavggbclzviopyunwysvtuxzbkhjkmqpkouizpdqgjfhsgrljzbhzqzdejmaqsxevrvntlyujiucedglcnlyvsugcekivyvohoqteotykbgayvjaxfjkcgjuynsqxrjxwrpfqzdercllzjzjewsrucnhogtpaxodrigbcczpujogohqipxjpmgpuvfwfjfgzcbdujepzkdbmnepbelghzuuszqmtukuctfclbdsozuuaowirtprrpifuywthctaiyhnqdgfmazyuundtbiwazlafwuidbtzwtcgbkqsjudjusabhwcaxckzdlczqsqakikpnevgtlwtidmivhoyagfpjqlxxtmkvgayyfzodrsgiqerqrxnesbvxwkxggvdqfntccspechwievlobrrhklhokxlfbnhxfteqknsjnxopbeseogemzerschmjdmzgnknlxgjdzlvnauwumickqerfooowuhnividbocxhgbnbkbyfhziqljhekoflegdgpjnsbrislfuquyxufsvfcvbjgujhmajubmfpeavaqviqwdvlaodygxfvrpqcxxckaqaxifmlutwwkcwfnynekajyxrzrulyewzoyoukoqczeurksluqbanwadnmfxgktwgosggkrhswufosiouxxitmgvhpbjachyusscngaznattqvjqkzhokjzbliugtujqjpigutbndavkfdpnmeqfvurbfrsydcwcrkhdowswrnoasdcbqfrozdapfpecdihjuyattqjbyldruwyvlhafdvlgmalppyhwvzjantfhegnprhmuhkfdtsprtcqjaqhsrjwsllicjfrafcajgbaxhxdtcllytkdbikhdvnpdaqebfhutbawwayzhvjvasudgkdewzikqxzmszelrhwkaeszjcibwihdrnqbayoilyqsjsiaskspmclqxnoqfokzqericwgmedtyakjtqosdrdhnjcvpnqlkjuxkwzjjelshvcoerktihofjnnlsvyunlxltaixlisluweevgfhgvfwxgoiscfjgsjnwerwbfovuijyeelyadpmodpvtldricsyujpbpsppgxoyombhtzgsourfxigiwpubypoevisfdbnwflqyzddhfiismpgiimxnneqxblshtjthjavppupkfkdbaclwuhbnomrjazzuquuxaktxkslruulaovdoklwgavqlduxluuyckooqbmkkeqsrpgtazgkvdpwztwsqwdsowbzcfdjbhpveuaxzbvixghjrwpvaqrucvzhnefkmkphknxslkmyjgfznkicpsorryudazukdqyhvldbbotuuhanbpwayschiodoyfmxhgxvjienvsnydorhdqmuxludesbmmjcgqmsrwbdmujafymirdpdioszdmdohcuasepfiacqmbnwwelkqphysffgwclwhhrdmbcqshaqbcmexgzbuzpsohojacxzcnoxluwdhdlbpgftvomvxrxextkmiybthjwhgmdgoudfgmhsnaxreroobmxljvpziffebglzmntleonphiqejgruvulnkcaxvqcodmhoeomditvsveqryvdtvuvwofqzhjhdqyqzcsmwksywvovqalgsxshecwhchhtqkaugpeuekhipexzlhbihusecyerycbogdpqvnbjlbopfplfeqceqwdjpqamidupzwznkdcbyuzswjeirxvbbxnawohywuerwkfcuqjlvwimhwwrqmlecxhioynjypgpmwdegmasnotdjjiukrejdmmbgpujsmyqnuseeqqpzavtqxtpndhswauurdzfofubfzzbudmzeshjfoygvktmjwezvkwaibscrozrbbafuaojrcqkjzftxbrkwqflmegedwtycndeebyosogphwjuczksndnobodyjkbvhhgmbjrulcwksxlwjkxahduwbstrumlhgzmipcicuygsljxinhtndqyllcuullhzscovuvzrqbfpnsyfscgmsjaibaiqjsnowtzwcqqservtztytsjrcom	["bozqnvcajonzfmakzqpzjkhoublnl", "edoghhipjqbmoeqpmwibbqpyipzpy", "hxsahotmawccszwnjxwpjkivyckfu", "cllzjzjewsrucnhogtpaxodrigbcc", "siegngsdmknpzubvjgdvgjusstqkt", "ijfjedhtgodeermsycuhfdqbobsak", "jiomdvbddeaqvbguajbfjplleghal", "nkwydiyqldivcjxswkozmckaqvjht", "sbtgkxhqqonsbgyicwofjwenhecbn", "zdzynmjvipfhheoqmjxujbdtymzab", "ivwbbwswcqbwrioaxjvxkrscyhyoj", "glmmvzmxphqgneyfvhosejskjunix", "vqaifufbmoedvndofyrikvfppqpbd", "lcnlyvsugcekivyvohoqteotykbga", "yompqsldhpcmrgobvliyqazqecnxs", "sgwhuewcxcpxoisupceqgdfinwdhy", "gfcluycedjqkyegdgkgblnqgupsof", "yvjaxfjkcgjuynsqxrjxwrpfqzder", "himrmdlhcpnbrxsvpionyjahpnjvh", "kxdvxlvdyytjpsbydqpvzczouemxo", "rdpdioszdmdohcuasepfiacqmbnww", "schiodoyfmxhgxvjienvsnydorhdq", "djbhpveuaxzbvixghjrwpvaqrucvz", "rdczwvzryxetnvnxnvmvgszukxyhe", "ivdxglyrgkufeqgebqaconcpfahrt", "bvhehdouaigcyakogvyrsmbtgsflt", "pqwdqytltqifvmnywyqgezjlidsnt", "noasdcbqfrozdapfpecdihjuyattq", "svgjkfxdvqqtryhehmxkbgupktbzd", "wtivfmwqgeckdqzjznqfahrngmbnq", "kjhrqrckhcgppswtcmswrapgyphhh", "uvaufpjxhnkgbkydjjlxufaikkvnn", "jyadvxrlpdjbpkwxwsgedcqtszxct", "hyevxxclippoalaqwsywpvxtjgftw", "trugcipcczxuhnynfcgioprzkqhpj", "vucqnrletesccghijkzdeozcclcbn", "elkqphysffgwclwhhrdmbcqshaqbc", "ucwgrwqzokwlctqhljtcwzbgiuvyt", "howyrolduvjwalijzyupvbiovylds", "taiyhnqdgfmazyuundtbiwazlafwu", "hnefkmkphknxslkmyjgfznkicpsor", "gfpjqlxxtmkvgayyfzodrsgiqerqr", "caljicyrrnmydlyfefznpmxfugcuw", "cwhkaiikmbjksmqkoferlsgzmyade", "cixwlssvgihqpmkukbgtglqfvgtqg", "wbobltcxlkqtuxugkwyqlhihgbiua", "qurnbuifbbsszfvpeyfuahmefwwlv", "lnnvonndarrohcgbzcdwciwqplpab", "lvqeekefaqrgurtguojdkwezixjcl", "ohvigietfgjivmalgetaykxxewznm", "clqxnoqfokzqericwgmedtyakjtqo", "yqfexewsclgrdwaygophmlixlfkib", "dlczqsqakikpnevgtlwtidmivhoya", "djwfzgipmzgnktrowcwtfmfcxqpwb", "kvlnjfiwoaigokwtoellqbzrvezaz", "mvchxcexgxjxspqmyqvahaynakabq", "zeyartcnorvrggpqjvninjwtwsstq", "hyblwvloanvriaxnwtiefkzyrbfex", "nnpecwitutgwlyvmpveufyliqrzmu", "piqlbphpievespgvhoikxxbnbinzm", "qhfshcdngfkdlvbmwjssjephgvlcl", "vzqdswkrlxlxjcviabqqvaboaeasr", "nigkfheyovxjbsyvvvadrypcagwtl", "ovdnoufnlgnvtkiexellepwfkjuqs", "qlemayfprxexqxhvdpywmfwdfydhj", "ttrlautnhjzorkbtftwvvckkjlomr", "cajmiuekspicvvrmeehxsurblqiqb", "rzrulyewzoyoukoqczeurksluqban", "rnlfzlfwjpszospywvxkpthgxkomm", "mxnneqxblshtjthjavppupkfkdbac", "pdgapqjkwctmjzedjurvrhoaxdswy", "trrejypdoanpsplzemscaswstwbxa", "wehimsqnjeufvnfvvtttyzbkzhewh", "tbwgyjwpzqonydiwtsztlqdpapjgq", "klbbtoqfppmaclyfcqfbpuebuxppf", "bhzqzdejmaqsxevrvntlyujiucedg", "afutxqnaoegvjldjtxbgslqbgkzad", "givqmxqdykvoodzpdpemjdzjuhyxc", "kdxwyyatkunlyfdjsshkgmdfknjoz", "nsbrislfuquyxufsvfcvbjgujhmaj", "lwuhbnomrjazzuquuxaktxkslruul", "ohtbxoxvskkmabekujkqqihcbpihs", "weevgfhgvfwxgoiscfjgsjnwerwbf", "wsxkfkpbrfpyugfbhqmzfvpotiotl", "zfrdnmtbrzazunypgwrljcxigoxph", "dhxyylfdritymmdhixcaopabxvflf", "jcibwihdrnqbayoilyqsjsiaskspm", "xnesbvxwkxggvdqfntccspechwiev", "xxckaqaxifmlutwwkcwfnynekajyx", "kgqykiashtjgeqvqisdbuaiglrigw", "wyyxyrngyztxayxsvlsnmcqlpdhks", "sdrdhnjcvpnqlkjuxkwzjjelshvco", "kdbikhdvnpdaqebfhutbawwayzhvj", "erktihofjnnlsvyunlxltaixlislu", "kpfrisptpqgcdinczlccrqglxykgd", "gyftcqkjehanmilipltltxfjyslsd", "omhslrkdwqpltelevohfawvnxddfq", "tfclbdsozuuaowirtprrpifuywthc", "mzuzkrjnfkggelpffwiyfmumbjcxk", "njoenamfvtfehwnqmyxbrqbchngxz", "spadpielmiyhllfwacywcqjjxseow", "jjjnutlrtpbjvuusyfwovuloexonm", "zpujogohqipxjpmgpuvfwfjfgzcbd", "yoqwceovypqbfrwkjbmtnectrhfrs", "eyhqassplmwufwesssuytbfhspcxl", "rnkkudjeqqrkeiinfmetljukjklpa", "joukltaqgwiddpczrrodbrjxsijfm", "muxludesbmmjcgqmsrwbdmujafymi", "vvvavpgcrrkqjxlhezuoydgucmsqq", "bptbuxrpjcsomvmzxesbodhfviqqj", "hnjtvczqnsaycttlvetwsrftgdyca", "wadnmfxgktwgosggkrhswufosioux", "ppjjidldipfsfwtiwpvjfcuuyjejt", "nunwqkvbhmumtwhaijgvoszqdooag", "ahmdswzvkgwuezamvtbggnoztssdl", "reykwyfoqaxtafsspqhjscljhctze", "vxcmmzvfnavmgsamgoqjgjmkkmehy", "ursltrdteilkyqkxknqrwcaravxqd", "lobrrhklhokxlfbnhxfteqknsjnxo", "rybptntjkhhqqksaesjlkbodpxzpv", "eqsrpgtazgkvdpwztwsqwdsowbzcf", "bfyhtvfivujpvkkxcfuwrqhvvbcrl", "vpeytxrquxpmahultowtqqjjmmggm", "idshujzgorlhjzcirnborqgvdatqb", "zumjscfgojxolkdulvhystwfchujj", "gmjnpifcbwimroqhugmgkyyidblrd", "bpsppgxoyombhtzgsourfxigiwpub", "cfofhjxpcqdicvftaqpqcoppyreyu", "evrcpyndtakjysvknujyzrezojzth", "vasudgkdewzikqxzmszelrhwkaesz", "dfeipdzzccanljubbyfmraznkqsqy", "qhtlcuwgaqjgjloruedyhxffgzrgf", "reylghbeuigzkzkwzucjftqqatjet", "jxhgdnrhvzggeatmvunxwewrryuii", "hqnetoojnqliehphtjsammovdfcam", "jurzdtqxjlowxshpngneopxyzfcrx", "ygdtldwmqtkqlylptamgihgpvmrqy", "bhbuyvvhgwylroofsiqqcmbydnqqd", "pszlfmubdkvofdozxdbqfqxbqsnzj", "upakjkqtoghzluinjkvoicchtdmsa", "ovuijyeelyadpmodpvtldricsyujp", "zlvnauwumickqerfooowuhnividbo", "hcldgwtzavfjtvybiehvngdfwczpz", "qcwywmakpejtwkpdiacbpdsvlxgyp", "rjguafugusfxlptnacjdrretcnqxp", "ritqcmvzlfqmzubvawinfomdcxsjy", "fwivikegqqgzskmtmjammzslwladr", "hxqtnwdnjjdtpwbaagqnnoywgbhgg", "qkzhokjzbliugtujqjpigutbndavk", "tbyochcgqavggbclzviopyunwysvt", "cxhgbnbkbyfhziqljhekoflegdgpj", "dhsrlnuhphtvodnpylaqbrbjvkgtf", "jscsmiqsurkuelmwvwgbzfagobsbt", "clhdinjmwuuggcotpnhotcwgyozvc", "euriqkqjgcdrjhjzwswatacsydfvg", "rjwsllicjfrafcajgbaxhxdtcllyt", "fxzorwgiuemkhvaymqnilrazrkdgj", "cnyyvrreyiehrcstfmunivhteoudx", "lhxkhrmhpioefxwbbkytxcwnnyaxz", "ensumtiesnqyfiwrsntqupxdbqnex", "dbtpixrozcivhhvgsgladcrgpzxpt", "ycvjpmsvitekejvafguwlmlkycwzt", "tyupdaotqyhnmthkrkpidxhohidkv", "votrxbesbxfujjlylrfazmecxshdh", "xqdduujojrqxjtllfwzptmymocgry", "ryudazukdqyhvldbbotuuhanbpway", "izldrebdsnuiubhhuzespanmrfuut", "ecgepbbsmqcgzsaeixweiidkfxsce", "ukmxhjsciuqcfwguyoefnnfsrfovu", "aamzcjjgtacvuzseodbpwidjthfci", "lxryiekbizslvvisezceudyljwvko", "vfcymczdblaktjrvuinikyjcyastc", "wjphgslrggwhqmsptozpjwysgttju", "iiuzplwoaenjomubjvpdibfuabckc", "mbvzcweqpjtqmcfkccoguyypbfjoe", "uxzbkhjkmqpkouizpdqgjfhsgrljz", "iswimlixnfzadmzhjkponkkpakufk", "xelsownbyxinlhwayvspdludwfxnx", "antfhegnprhmuhkfdtsprtcqjaqhs", "jwmgkidqhywmhnnpuoyguthsutzoi", "ngcshkshrlzvtbadmxtidgllrkdqs", "xitmgvhpbjachyusscngaznattqvj", "yesxohkazofzqdshgcsocnuxzfvat", "xhuutlowtlraieqnrkitruonzyctl", "ujepzkdbmnepbelghzuuszqmtukuc", "idbtzwtcgbkqsjudjusabhwcaxckz", "ypoevisfdbnwflqyzddhfiismpgii", "loxfyjbrjmakwxzqceoxtpsbjugus", "pbeseogemzerschmjdmzgnknlxgjd", "vliaxmfzfgpqvagkqdzjwgxfokewi", "wrojlmhbqcoimitwgkzikpgzpqfda", "slbxulpnswnokyfwnytpboiajcfpo", "bklkkfgrhlpfypfuegzuvcogphjjh", "ktggjsuvphmisrkrqrjdenqqjcwjl", "vwjideiuvnnwahgszpbgslcplmqqw", "mbkfaeemodbrjerjgacvjylkxfcaj", "vnxbqeitbbqvzwcgwzojjfvexubhs", "wrxwhsuivtaslwrmdhvqoiomdpryu", "ubmfpeavaqviqwdvlaodygxfvrpqc", "mwdeztrxlwrpnkcxphtamqqapynbf", "tkekfxahjzqbhdufqfevgzkzhzgde", "vxubhdxneabeaihxbotkofodllxej", "onrkpjcbpyjnfgreclfzdbmtneeyb", "aovdoklwgavqlduxluuyckooqbmkk", "pbwvtcgbruupfcaseryemkxmlydpx", "ldlbprpoiciaklxwwuayglnltqduq", "fdpnmeqfvurbfrsydcwcrkhdowswr", "jbyldruwyvlhafdvlgmalppyhwvzj"]	[373]	TODO
txejroiucuxwvdoxpvbyaoxpnkjcbtjijtnkyuktbqzhkhrcrpmltxtmqkcvknlxuhqwjcnloweasxjjnjqmgawjetffumkuhrmedkbtoahciqmuipzqnnrpzevzepuzvmpzjsbdujoiixcfzrhmbkctrluaibvoznolelfdsnvxvykauaqbpxivprtsfhigaybmvgpufmoljspotjlpenwjtmrevgoiblihbdjgpebunqomtdfqpibetpyovdwjizpcebvlahkqzdpbwxvfyoxkzevxksgmdocwlyxfqejdwtxyjrusnoewbnsnelnwdiofnpdelckxfqdmhdqarkpcjwbixuubiogutyelzrpfxjfccoopstacnoqvlqxwiwmijpwosfziurerkuvgiisbykhvggqecgsnxqxijvgoyhnxjdnkvdnqpxmvnenbjdugnosxclpmdcxijsmpwnoraojqbovyrvitgvodezdlibwkakbdykxevplxtpdrmagrimoswbgtrrmltbrnzycsbuicpvdciodfoboxfuhsrxrcoqtxrpipppsomzmuhefpdznlmvcrieqwyddmkhgimkwkyykeiilhthetrxcemxrjboonfmtflniahmmkbosipnfssdydtmiiowtnwbbxtcilriapktaimloefdygdzdtysujhrplqddhhumdtdvzrrqqorjibifmxfhgduukdddbdeavwbvupmstirrggsgmlzcrmrzeosaikzoliglargveslhkcnjuwnryicrloomvjxgknbpipnswhbontewngbjsfwgnxcsfllijyskreguteomqtweqntwinbbdgvlbfwybpxflwpygzllbxtssbgoudyajqflhrxydibftqzeqjbsgcnypfapogndhcfpeyiwzctuvudmyssiodnzodeqjpyqaulkwwlktywxwgxhkuyadosirwakreghquafwfbmtuaneiviiphvtroructcvpnmeqccjgileoxjyckzxaxhjgwysnzbfwzxpfwzaujwlehxvsvcziyosjqmvdzwpuahfdxkaplfoenfkddkxgvtmuuvqtqjtzpeqmfwftrnsucfaxirmorwhfqbgwwqnrkfrtrqrqphsammrtbtopnevpakfecbxuqjihrguswauydryacawimqaarlwdndsecxzpnuwlawxutdxfuddmymaujeaxkzzuxuqsugcxiworfcdfjwcvkjvabbrntizhbqrroeywfatsjsyeqtngyswwvzkorwpppsazwewbwnhadsmnvncpetfzbioczzxfabgddcafrckxjlafhjvulwtyzytukhpglhjrkfsmagxcbrdlwtkhnwsmxxnqcglunscljolczpetawyewxtksajiboxpmgpwkaoacqyryccguuomojlifdpprwjtczzuvhxlbenwxirxikxyapmkyfbmbwtekbeqyuiwptlzrnheyciextiepcpsteynqcerrstvxyallibaqfwzezgofxbpuwgsihogrjnjvqagxhyzwjnchfnmkzfnnapuczfpliugvahcisitrugwprliizbuaqujdpbfsbxbhcgkoqnwsrjwpdzadbauvxymmkfszyvotkaofqxyvgxmlhdfyufgxugxnatngxvgdiulaoximftlnvzovgmrfckclkbusoezydjpbpdtvayaiychtiweeoxbvorzqvmitoabzmcxattxkpgndifwwkueacpzkfbwnoumvcstgxjbnztqbpgziepjvhhemyfwqfwusqiltynulnewcjkqtithkltkxglzsvtmmiomnhuhaevyieiivflezychbmvvvxvajgaonapdnwcurpcjvmbxlgrngydydterpwkgecjfuwcrfsmkduqfehioshdmoybtjzqtitpczxdcteusqdjkiksvdzvrkhgaohxwontjvsnxwmbfdyivhvrixjfeqawuiamwsmvusshpsjhnvydfphpnphplcckejlgilyifpkvyacobzrpeyjpipxmvylnsvrofulsqvbfbenfpbvlmcuixxtidwbzegxoeqcyueubowptunlmrlulqinnmtweqdujkgvyhvmgsggsrbdpnaiehbfhrbzvvtpdpwcnerfkdapooltvffnmeiaafviyvscwpdklouxrxnkcjmlmrowaydbbmrwshbquxrjpreslfemmgjmdewzcptffgrynprwnphgvzlfgbfgdmgkeiwadzllcnarfjuibjdxlrkugiejbhxdjdmcdlnhosynrkbcxayghognwoxmgcpzhfcturlohvvkehbmrmgyxxldfqqaxjafujeumtohxgdumaubdfmbklvtcmhkjitjnsokaqqrjnfhecywayzpaxdyxixgcjzrijujiqkkgtajpgxkthchcjqyymithbglkgqmogkzqplooqvjujqgsyifyfedexffwjrvztxqeqtulxykertyufbldqrwtsbnipabebsjaxyfcvihyfqyddxmnlymrmnefdaxxmebxiqwosddjngiqktghngykccihojcotfffhinbvqkdhmyauiizemkvimfyxddjljnpkwsegewzpjsqyxecafkxiteyvksfadhpprlxsohypbrrlxdcyfwneconuccxoknzmhhqfffhqqwizgpkxrjmqdnsotupwzewhtpmgvvlmqwmlclpdsfnncphfquieetzqpnlwaskzekjvhutbpnuschyoxzuuzudgzrcdousbnihsiovshhmkcyvwjxmlxeuhvgicpvgcozowjfpgwpritotkfmvngvaknxbccdewqbjipzqcghpqgqcxplsoeuacooqwtkyawshrabekojcubevsrbisrjlnpclezawkuatxodqqivegzzkcimlpxscnhzposfsvkabduvkcrfsiggedfblnxmwgnrmqssuftbouxvckljzbzpagsfftcbqbppvlwatwojwppibiktrkdobnmgzidegyjwavdvqbppdhqxjcjmuioiuxqzynebotmfxdwmxrpukjoxweamvrtayavhenjbujgviivlpwkiadydygeeaemewsmcqjpsdxuhyvebeigmvteqpjlwtocwrcihwdbgbinkocnbqiumreqaurdtkhztwiljhyzonmshcdoxvoxltmptblrzdrzeejtzvbhatrrfvkybvenoegydbneviqnsrndltbpbfsgyeinmvyxwbpergyjsrvmeadrvasxjzmsptepxrmafpksoxiiyltcfveyundjwefcshabyaxbkqhsulowsjtygsageutrpgdynuwlssnemswugawyfzvaaiykbntsrspbvcnuokqxgfvhksqtsnhzusyrenhsdnhmbaukqqsljupsajxzorujhlwmjdsbqbuvoueudkliwioeycqaeqczcunwaeunabairwcxoulabqmmxqdukomblnufgucybjzchrwgiokgukcofjhtevibabqyrxagesvzoqgwubibzqlcbdfqtqvavngyvwtwgxkuubwbfzfretdadjnsbstjegsnivkscosgkpdueofyoofrechaohguzymrpkoxsckfsppnmvhocwkxtarocqlfrlevabitgugkgxogceudckupqrtvhkyyhcqcgscavvpnrtfeqfwoimmsttulwwvdumhgsnwzqimhrizxdyfajrzkftxbnixztfgsiiaxpdcahcbutpakavxlxfnvedsqolmywdpcnajayyakrbxohfscspjklrgqzrfnovbvbyuwvxhohcqfakqzirwwqipeevftigxctoihckgnblixvxvoksxcvnhzqkuarhyceznhlfanmodsptrbslebxmtzkbvzypfcgbybqgmpuelgszdmjybgyrpxpmhbfkgvzijedhjdtdysqcsruaswoyqzouiznsxmvfpzwuqwaiqzqwisdxgbqliikfboojocmzrwzhyvkraftxjvfzxhyylvtwgyvmtvmcqzncsodznshozkohddsczatfgxcpcixxbayvfrvijrwlzadenwhmdocopqtaaororzfqcyxnmdomzbewuzwqhtimdraukojtjmdnyukjsshdhzeomcthcfhjsilpkdeadleckfzgjhyqoithgbfvqkpkutikvsezgyfturqyyirdfrtxppcoivscootriqcdfqvfhmuqifnqqnzlccqqlmosojjwrwgqpkjmyypnzgeererdvvnevakcgvusqewjixjzebmqefyvxmtcazhtvacktggahrgkkzyftlxdzezhebnwtawxbiebsjobmnmlwjumdxdsusrevtrvhbiocvkogskgdltfstfzhoqjchtlhgefeazhtwgqgihjwlupyppstyrfqgmuaegwwfdmiypqnurylcraastxfckxdkomimwzcezprfyipunbcbolhoqkwcsetiefbrgexcolaakkayzlwxvdfmpriwsftksizysxzcpvjcefmgzwmaerdophaykahejxccfrqajiybeydqodnuxqjzugynyqgatsjforkdexxjqbbtattrdlbszmekpjqdirowgvghrnevzaxdajousksalwpivlalnfxflnknwraklbpfwmcpllkaxrhrninwpatiswbpbxinosbxsewgrlyjnemwvkomqytwjirwjpldwnzpfnxdhqcvliseucfezeglasxgygojrjudoometizwfqfposoxnzpqdmhccezdizmyjwcyzijgxmvfqgnfffjorpmdonmymkholydlziuvbhyvwjwrmayrnyxajaehqugbwykkmndusghqzdvnmqtkcjqnfyxhwnyjooxoxuligpaclirlvfhlutjfkgnorldwduxubgieojhskkcdtnftmupkfgvsutqdtmdcghampcqruoxihwiawaqrynxymtfutlcppypjmywudsbupgxrytehuusntjztsfdytjvtsetmniucsodfjymoyehwtonxnqdubmtxgtarfxdofmzulwoagedpupmmoemkguqhizyevgbwrbknuvsgmwomfxmznnlfnckbiodlnvhijdbjtvtzsymopmjgndawopmwmpxnmcuhjbqjjdliclwxhvwauqpoyfajhrohqofbkhwvihogexmtclaccnmzcajwjesbtofmeisdlcyryjrualgjhrjnlslakromkwkfteoyaauerrelnxqxkrdhhrbaplqcogsjjivcoaxklmvxxufqfozwyiprwyqviwpktntjqhxcvrwbrtvdjagvjolxaiihzdqbpdlytpuovwklnprhndfvizihbfcilorbrnmcgmmykjajblqzrxaevjmomcyjwmwunwgclcthzhpteltxphnwgkagupzmfnmrjgeassisbaxdfjbvgzdvwukmpkwxjwlsirzhjrbyhlgwqedoewgcwrbczuyjkxfmkfvaqjguqhnwzpxprwvbujgujtyahusafbuoleoctvtzmhebszivoqhqsqnrddhlsjqgbbsijxrxcsolaweigmakqsznmoxspzlqigxywjeirbmlzgwpgdihwbawyrpbrtvgpitfksetxglvhowwtzszitknritpfoovkowjccjyvaqrfpugevpdhcqwpqfvinrmhbxyeehnwtbrersolyremvgpuanbqiutrxnamadwhatmlaosgkngerhpoasbjsimbuqbxnzrsurcakhwhabtjjdegnazqhwsjpvpgxvlxjubxjngftqmkygblliidtordfsykbxewvadpqjvabspmyshxhkuldfilyzvwazjidcdnnueuslufrjkyswxzrjjnjplcpsqlonjxniopkohtpsnwqskvcxdnzcrgovbqdltemjllpeyjklhcrajebcfiqqeiuavapxwcfxmhzlqysuujaytoteyqkcxkocezlcrtkilymihscjiysfasvgmdaxcflvgvksxjoqsxxtiykphfaiyisyvzdkcfdaygzdzhkqgqaqfpowhfzsdqfzdjkomfrlairdkunbqssoycaedanwzrwqwoiwzgxasjugjndrdwkciehamsdnheevbdquymxghxhqvuhzmqftkkhlebhzdtasvnvekihaypzppvepuxqkquhlrfyheerwcjcbnnhocotvcsmgtpbsejgxuucqdefjiakusdllbyepffxphjytqixdcykxbigcjbffxzzjyeuboxqgefgyqwcxjbrwgsutvfgrgpwtowrqahhknzognwwxutqeasqiylgttiilteixzkswyiiltugitlsvgwltxzrjrgdfhxkhqgscshmahghourgguuqotadrwnsasgimhoibeuozggjpdtoabufixoeavkubrczynbmfbxfqmujdbdurdpebmovvvhxowhaljstkiecbpzasqvhwwzuwjvegcuuthxwqtncigscoayiwqkycwytaeswvvwxrdaxasyjlgnqylajbpseigsjhnhraskjzpgswirvsimcnsztysqzlmldkexekstkwpgjasfmxccvorxdhzddwrwlvardtcfnxvhtuwzoirryqlftlosonesdwokwwtksodaopvedyarrpqciijwuteszugkmqxq	["cbxuqjihrguswauydryacawimq", "cshabyaxbkqhsulowsjtygsage", "hvrixjfeqawuiamwsmvusshpsj", "mjgndawopmwmpxnmcuhjbqjjdl", "snzbfwzxpfwzaujwlehxvsvczi", "iaxpdcahcbutpakavxlxfnveds", "nypfapogndhcfpeyiwzctuvudm", "rfpugevpdhcqwpqfvinrmhbxye", "hnvydfphpnphplcckejlgilyif", "bfzfretdadjnsbstjegsnivksc", "lezychbmvvvxvajgaonapdnwcu", "ftksizysxzcpvjcefmgzwmaerd", "bwykkmndusghqzdvnmqtkcjqnf", "oeywfatsjsyeqtngyswwvzkorw", "zcrmrzeosaikzoliglargveslh", "ecgsnxqxijvgoyhnxjdnkvdnqp", "ijxrxcsolaweigmakqsznmoxsp", "ujqgsyifyfedexffwjrvztxqeq", "pkvyacobzrpeyjpipxmvylnsvr", "ofmzulwoagedpupmmoemkguqhi", "hwvihogexmtclaccnmzcajwjes", "odfoboxfuhsrxrcoqtxrpippps", "yxhwnyjooxoxuligpaclirlvfh", "orfcdfjwcvkjvabbrntizhbqrr", "xglzsvtmmiomnhuhaevyieiivf", "gyrpxpmhbfkgvzijedhjdtdysq", "buaqujdpbfsbxbhcgkoqnwsrjw", "libaqfwzezgofxbpuwgsihogrj", "yosjqmvdzwpuahfdxkaplfoenf", "hgimkwkyykeiilhthetrxcemxr", "swbgtrrmltbrnzycsbuicpvdci", "awxbiebsjobmnmlwjumdxdsusr", "okaqqrjnfhecywayzpaxdyxixg", "osgkpdueofyoofrechaohguzym", "brdlwtkhnwsmxxnqcglunscljo", "myypnzgeererdvvnevakcgvusq", "gndifwwkueacpzkfbwnoumvcst", "xppcoivscootriqcdfqvfhmuqi", "rpcjvmbxlgrngydydterpwkgec", "sisbaxdfjbvgzdvwukmpkwxjwl", "bwkakbdykxevplxtpdrmagrimo", "nmshcdoxvoxltmptblrzdrzeej", "sqtsnhzusyrenhsdnhmbaukqqs", "tulxykertyufbldqrwtsbnipab", "mlclpdsfnncphfquieetzqpnlw", "zyevgbwrbknuvsgmwomfxmznnl", "mvxxufqfozwyiprwyqviwpktnt", "ewjixjzebmqefyvxmtcazhtvac", "zrwzhyvkraftxjvfzxhyylvtwg", "xgdumaubdfmbklvtcmhkjitjns", "tevibabqyrxagesvzoqgwubibz", "pzqcghpqgqcxplsoeuacooqwtk", "busoezydjpbpdtvayaiychtiwe", "wyrpbrtvgpitfksetxglvhowwt", "hbfcilorbrnmcgmmykjajblqzr", "qolmywdpcnajayyakrbxohfscs", "yvmtvmcqzncsodznshozkohdds", "ritotkfmvngvaknxbccdewqbji", "imloefdygdzdtysujhrplqddhh", "fnckbiodlnvhijdbjtvtzsymop", "jboonfmtflniahmmkbosipnfss", "urylcraastxfckxdkomimwzcez", "pjklrgqzrfnovbvbyuwvxhohcq", "ofulsqvbfbenfpbvlmcuixxtid", "jtczzuvhxlbenwxirxikxyapmk", "fwoimmsttulwwvdumhgsnwzqim", "egewzpjsqyxecafkxiteyvksfa", "ceznhlfanmodsptrbslebxmtzk", "zszitknritpfoovkowjccjyvaq", "nmeqccjgileoxjyckzxaxhjgwy", "pwosfziurerkuvgiisbykhvggq", "fqgnfffjorpmdonmymkholydlz", "teltxphnwgkagupzmfnmrjgeas", "lcppypjmywudsbupgxrytehuus", "prfyipunbcbolhoqkwcsetiefb", "xyvgxmlhdfyufgxugxnatngxvg", "vghrnevzaxdajousksalwpivla", "udyajqflhrxydibftqzeqjbsgc", "nbqiumreqaurdtkhztwiljhyzo", "kcdtnftmupkfgvsutqdtmdcgha", "sirzhjrbyhlgwqedoewgcwrbcz", "yssiodnzodeqjpyqaulkwwlkty", "kgnblixvxvoksxcvnhzqkuarhy", "kdapooltvffnmeiaafviyvscwp", "ebotmfxdwmxrpukjoxweamvrta", "xaevjmomcyjwmwunwgclcthzhp", "czfpliugvahcisitrugwprliiz", "aaiykbntsrspbvcnuokqxgfvhk", "slakromkwkfteoyaauerrelnxq", "yfbmbwtekbeqyuiwptlzrnheyc", "yavhenjbujgviivlpwkiadydyg", "rhrninwpatiswbpbxinosbxsew", "ntjztsfdytjvtsetmniucsodfj", "gxjbnztqbpgziepjvhhemyfwqf", "waiqzqwisdxgbqliikfboojocm", "qlcbdfqtqvavngyvwtwgxkuubw", "ueudkliwioeycqaeqczcunwaeu", "pyppstyrfqgmuaegwwfdmiypqn", "lczpetawyewxtksajiboxpmgpw", "avdvqbppdhqxjcjmuioiuxqzyn", "ergyjsrvmeadrvasxjzmsptepx", "nmdomzbewuzwqhtimdraukojtj", "rmafpksoxiiyltcfveyundjwef", "uddmymaujeaxkzzuxuqsugcxiw", "wxwgxhkuyadosirwakreghquaf", "rnsucfaxirmorwhfqbgwwqnrkf", "lutjfkgnorldwduxubgieojhsk", "myauiizemkvimfyxddjljnpkws", "bdpnaiehbfhrbzvvtpdpwcnerf", "fakqzirwwqipeevftigxctoihc", "nabairwcxoulabqmmxqdukombl", "umdtdvzrrqqorjibifmxfhgduu", "hognwoxmgcpzhfcturlohvvkeh", "iqnsrndltbpbfsgyeinmvyxwbp", "csruaswoyqzouiznsxmvfpzwuq", "cjzrijujiqkkgtajpgxkthchcj", "ejbhxdjdmcdlnhosynrkbcxayg", "ktggahrgkkzyftlxdzezhebnwt", "ophaykahejxccfrqajiybeydqo", "ebsjaxyfcvihyfqyddxmnlymrm", "tzvbhatrrfvkybvenoegydbnev", "vulwtyzytukhpglhjrkfsmagxc", "eeaemewsmcqjpsdxuhyvebeigm", "eoxbvorzqvmitoabzmcxattxkp", "jfuwcrfsmkduqfehioshdmoybt", "askzekjvhutbpnuschyoxzuuzu", "vlbfwybpxflwpygzllbxtssbgo", "rgexcolaakkayzlwxvdfmpriws", "adenwhmdocopqtaaororzfqcyx", "pwnoraojqbovyrvitgvodezdli", "dgzrcdousbnihsiovshhmkcyvw", "wusqiltynulnewcjkqtithkltk", "czatfgxcpcixxbayvfrvijrwlz", "omzmuhefpdznlmvcrieqwyddmk", "nefdaxxmebxiqwosddjngiqktg", "oqjchtlhgefeazhtwgqgihjwlu", "iextiepcpsteynqcerrstvxyal", "jxmlxeuhvgicpvgcozowjfpgwp", "ymoyehwtonxnqdubmtxgtarfxd", "jqbbtattrdlbszmekpjqdirowg", "nswhbontewngbjsfwgnxcsflli", "bmrmgyxxldfqqaxjafujeumtoh", "kpkutikvsezgyfturqyyirdfrt", "grlyjnemwvkomqytwjirwjpldw", "ljupsajxzorujhlwmjdsbqbuvo", "dydtmiiowtnwbbxtcilriapkta", "evtrvhbiocvkogskgdltfstfzh", "iclwxhvwauqpoyfajhrohqofbk", "pdzadbauvxymmkfszyvotkaofq", "wfbmtuaneiviiphvtroructcvp", "lpxscnhzposfsvkabduvkcrfsi", "kddkxgvtmuuvqtqjtzpeqmfwft", "vrkhgaohxwontjvsnxwmbfdyiv", "hngykccihojcotfffhinbvqkdh", "dklouxrxnkcjmlmrowaydbbmrw", "kaoacqyryccguuomojlifdpprw", "zlqigxywjeirbmlzgwpgdihwba", "bioczzxfabgddcafrckxjlafhj", "wbzegxoeqcyueubowptunlmrlu", "vteqpjlwtocwrcihwdbgbinkoc", "utrpgdynuwlssnemswugawyfzv", "pclezawkuatxodqqivegzzkcim", "qlfrlevabitgugkgxogceudcku", "xmvnenbjdugnosxclpmdcxijsm", "yawshrabekojcubevsrbisrjln", "njvqagxhyzwjnchfnmkzfnnapu", "nufgucybjzchrwgiokgukcofjh", "fnqqnzlccqqlmosojjwrwgqpkj", "jqhxcvrwbrtvdjagvjolxaiihz", "lnfxflnknwraklbpfwmcpllkax", "lqinnmtweqdujkgvyhvmgsggsr", "aarlwdndsecxzpnuwlawxutdxf", "bujgujtyahusafbuoleoctvtzm", "kdddbdeavwbvupmstirrggsgml", "rtrqrqphsammrtbtopnevpakfe", "jzqtitpczxdcteusqdjkiksvdz", "nuccxoknzmhhqfffhqqwizgpkx", "kcnjuwnryicrloomvjxgknbpip", "hrizxdyfajrzkftxbnixztfgsi", "fxjfccoopstacnoqvlqxwiwmij", "pqrtvhkyyhcqcgscavvpnrtfeq", "jyskreguteomqtweqntwinbbdg", "hebszivoqhqsqnrddhlsjqgbbs", "eiwadzllcnarfjuibjdxlrkugi", "ojwppibiktrkdobnmgzidegyjw", "uyjkxfmkfvaqjguqhnwzpxprwv", "pppsazwewbwnhadsmnvncpetfz", "rjmqdnsotupwzewhtpmgvvlmqw", "xkrdhhrbaplqcogsjjivcoaxkl", "dqbpdlytpuovwklnprhndfvizi", "dhpprlxsohypbrrlxdcyfwneco", "tffgrynprwnphgvzlfgbfgdmgk", "iuvbhyvwjwrmayrnyxajaehqug", "zpqdmhccezdizmyjwcyzijgxmv", "qyymithbglkgqmogkzqplooqvj", "bvzypfcgbybqgmpuelgszdmjyb", "shbquxrjpreslfemmgjmdewzcp", "rpkoxsckfsppnmvhocwkxtaroc", "gygojrjudoometizwfqfposoxn", "mpcqruoxihwiawaqrynxymtfut", "nzpfnxdhqcvliseucfezeglasx", "diulaoximftlnvzovgmrfckclk", "ggedfblnxmwgnrmqssuftbouxv", "dnuxqjzugynyqgatsjforkdexx", "btofmeisdlcyryjrualgjhrjnl", "pkdeadleckfzgjhyqoithgbfvq", "mdnyukjsshdhzeomcthcfhjsil", "ckljzbzpagsfftcbqbppvlwatw"]	[363]	TODO
ppskuyptvseelchylodtaatkrldjdrmyqneulhqvgrfskqqgcpblojpujjbbphnpagyagayykjxnneohwjlildmcifslqepuhbepgnbjqrxuccsohnuhrajjnbysrbiottffwzsqagdliroemhzijggxvxgiohapyukyvyytiftjykpophnodzjuyikkzradlyfkmaifsssxytczohsfrxsptyngkbckannyfvapnbvljzzmrlqnbsynblzhfdpuiyfoinbpghkzrxbubiizvumqubhdmpoeitnjwgoddxllzbutowdijnzxpivuqivisygaxxrpzipjyclgouwkbillavnaxtvgvuowdugwkjcewtlifwfzbxishvixzxkxpxhjpgtazwpbzpytdasmdwndgvvlqdqpmxzukdiqnliwkdzaelclvhdumjnmbsshgldnumsemvfsntivyspidywnmcjfbxblxkjggbmnqhruyjykibxmuhjajhnubpazuxlrimliwrkrvexqtewlitcdyxonwlmaqkmigkjufrmwaqhhzmhcoaxkdaoncefcqlgggetmazvbzkxapbqbsbwrszmbjwnawzrgjdsqhcbrirkqyvbfqfygtzvvzcybpkwrcaryljpzpnzzcjraadrmqepzdecyltdcmfwwasitzauphlzjduydpehyycmomsvkdgdzylddjzyczpqlyjuzsugqxuylrigqhjzyyqblzajaoncpqxhdpdpvozvuasdaxqhnqxuodfvquovuamozueelyhuwurjptcytahdrqurdweojqdpuwwurlrenspthepokghfknycnnmqsavrykhppzhtmggwwjipzzkfwenckyayhtpcbgzllztmlxpwsqsmrjhessdjxemeugdvylvtzirerfehfmwytwsfurndnjwieuquumqvbrhyyicnxolarunmlxsjdagvekjpgjnvmsrzwgkhbvjyybtorhwlndkvconevifpvthgbmkzdopfcxcpbydpfanalbpvymnirahctvpxenbdsdypfeabpbgpoangtxhdgfebmhzxnckzxzqzjucokbfbssvfkwkjllskqmwsrpmjhmgnabmoohcquofjillilnqljhnkkcovtqthirrarkalesyjntdahpajkxonusylspwwfzyyxhordppoejwbzyuqnwubaheikbxwynrjugvtcsdubnktlytutqghflzlxtvnhiqdwlqyndfdrvxrrnmpndgsulnptcrcgyxdoxfmvesexgcczoewfmugwijzsppcbvxahzjmyxqnmjqimexwbduxmbynwehxhesfyewmolceyaczpaimzmqeqcphukfnlpdywuriakjwrwiqajhpohlyyptfuagsztqzlracbhyyhuajbnrjuimxqobsvvobrocighdvqbofvwalavyxxtzipjwsripsarmizubogcjayhjwmlfftozxkbgbynkwvsibroahvhurfbehbiqauodtajawxtwwfxxojuttdqsgbmdrfkmpeaxgfddbqnxbseaemwauhirbfqjimylfwqpfkjemftqpaalcjcqjdtdkjihyuwcnqzukpmskigakocomhyygmfjoojghczncjirrbqfogdixeahihtwvajiwqlwczahggzqlobofmaifxeoxsohikixmihtcjobrdiihcuxrboyrnpczfccwgnpwaxoxaacepgberoajglkzprakkldjnjtendobiprqaazkvvrapbvnjyyrtfphuibzlctizdipzasfthsexcpsmbwrrpzmljxlhnezitfcwdnzseykdicutymsbinbppxkrzqjdehswulnvcynsvehzxdctzuxhpwohhmgivtbjrprgbvcffjteekajtgaedvbgdllnrfqsmtchzmqootjnzfxdpumjjfiihbpzzvhxzyfazewsucivjruohckcjhpjenkyjpjgbnrckzxcdtrzglndtyivjqtsnzfqhapibxgwtmcxikoqglpftqlvqycusjudxymiuuilasxpycvxtnikuiuuufziumhdovhwjewqmqvzcsymzudwmzajtppfdggqsdwewvepvffopceqxvwhxjaaoznhfthdqhvqkxpdbwhhybfahlnbabsvtrmjslbgwfgpbnyocctvsyydtqklbapumufjarejowiaadwlerpvdzjxztqjlvfkcezqcyuvtmomsomkugdzlzczucgurptkqdmcbaraydcxhomsxshqmyoavfxemaqmehyrjpmmyyqjkwxmuflcazlcrxuzugevdnxirfekcezrfybgnfbftbjdrehmlbpdgmmfhqvyibdosmfeheroymfdxqsqztdqrafznhgvecbkreqzcouvesnzpeohnfhwnxeefmfzoixdtblkauddrzhqjthxyqqqberzxonjadzhmevtvaxxvfbryeykiymysbskjrrhlaqmpmintrgzywakxwstrnphgckegbigszncxvfaxppjdoovzqzuufurjtarjgfelsdxcgdsayxzvaffarseorcwglzeprypwfmcvaftqiuvgploxsjallyslswdwrcwctozlcuqsrwcqvpejidyifxzphhprjsgvqlmcsmbwknhutbbdvumlgegdecqgbksbvjscovyejtmvnhjtdcotdxqvubskwzwggubxyurllikazolwvozaytyfnqvczkzqccblfjmhdgnhfawlviaoslceqrgtbltutjayltjdxqdiusiawpvnpzkpujepjnomxwobzmmywaunivfbsmptiaemxtunhhjfmwzipbuggrrqxobkrmbjctoakqepfswqaiitokfbbobidzfleejdsmiylteqfbxdorqpbfmrjhnbrsbamuejcthjkbjlosuswutxgicezqtagjqsbridgebatdcdrxrzppoaqkgrmbmsghzvzajlddaqolddxfwvmztmxbiqzxslflmtjyrixvzyvhxqxfvltzwctxageisrensghqwfviagrdgtpsyxmrsztbqstgwurntznorcnmiwnlorsgcjffkarkbsaqrkssxzlcdnrwcwwmeungfgpliqgogryfbfdirgsfoqqkwhsenzmdqduikoujuqnvbrqjfpayvuzknlleemmrscjyvxlaenorlovhbttlqdvuuppmgdbobuklpgchrporeeztugyutizhqxwgpqxmdmwadyjqzvryhuvnriidyjgcnuiruozozivhuofvboreqbgrowqvcgzhrctlvdremxicjrrudnpdpahxafwlkiqbgtxsqcmlaftqygdxtavxxmzdlbggygvbbhpiydbqgnxbrprsoxkchfehzmddnnmpndqqoiqqkxibljvoduvgsqdhmosaljonbtuandaomvakroeqlqgsqtulpragpmzliwavubzclprrxcoxaqgujynidfwawzaeifqkezrxfscbepidmqroywafqaslveeqizwcneuswqpfmfggffxaqunferhhcixgjhbqbgsqkjbsalynhjfqedfoqxyctjivaylgenphxldumxilnolgxfbxiusnbwjsoyonqbabxrgltqmhomgjhwuejrvderrjdubdpgkwhuwodkohgxjkfbquyvzneabvezuhlcmqxkopsgpymrewjijmxkjrtuenwpalijltzobmblzhiahdkaumofidpyrgivsytnmuhhaxwvfeoqwxnjfluzdoghblmpyiyzktitaxeszadidrdkrtflppwmdpsxqxokasbqgysfwtzsgqchtnlerwffppipvusoivoqiqbeycwxcoxmmxfifeokwuskioxjbjncjpdlinfgmidktgxylyrvqwuripvyiyvpbagyfvbqqkktnmvjtxtchqgzpadqhjvifadiykiysfvzqdgtpbkvbnflbklirkjytbukqmzslxwqvdtswicqvuhlthbgvuiivkfvdrcdtydzexwftybefxeaeyihfjzmrrdqubpqajrdszkhslikxcrzvnowfnpylcjusidiplhtzpyhddpmxqxqsjwdbgffiagwktbayelshouphyuejpebzbkcwlniazxourwhamsazroogwneggtqwecmxhbdizhvuhkiwjgbmxcnhhkdpeggybdnikiyxrrkoehispojvmxkwhapircdaeighjefvjvbgkooudwyufejxkirfpqnhiolkaxufwppkfbtkqmcexlzmisqqssqlhqgjxruxxolzctxningonqzvszltwlrmqfybyhrativkswomcxzhbjvvvpzkpugpsxlfbisnjcobopfkvrvqvslgcejekeqjoquazifkgyhfiqwxtkbrcbhltjibsigfirnausorxryryttpenqddqufnkzzfqrromkhnezgnphlxypohmhgmdvjcegaeqmnlganhmzauiapdzegxbaqmojonrwvrpcrahvjwbhnynrfwakfdrxadswohmbodnuiujdjupqhrybewwoszyzhxitxxjjpbxlgsgrzctrkpyfptttdvdphwxbfuskkkvjyavgqiqmljhplyiurmorvajmexplmnjtbofiabbagirsunrwygeoisztvhrpuvxkbzfgcrzbjupfbflupehqwztgrgawaspdlvttxdanoodacsbemxzvyuugrbuvvynpihxtddhfqductkgrmlbtngfwvgksxotyonvfivxinpphaczjctvfxmhwsvnkehenuxuvwpxaavjqognkxtvermbwgpglvljyqbihmonciqnnvxownibvxovmxukwuzrstudrhzpeorgbcxxhoivjngogtedljqsvuoenswplzaxgsedqjnjxzmkuqasjaztinapzanipetckaikhvobxehpzjckxgirogxurdmfvindgvakdvhvhhnrcqfakzkxqhposutakhzuvpcjnyrutwmvhwyvirlizdaltlabqpgvnbtxsgphdumpnrnpsjqlzsmunckszackgmlospyoozfmuudrepijtbbqswsmjegrqgddcffvoephvyrfenaugsuonzrxyhtjkfirxzbjjmnotwtucwebukniqvojmpqgkzqhnbafffcylkhypeutqisxxlsfgspnlvaaqbsxefjivnddkoqmnslsdnpczafiodktkyalafiydmfcrbrvkraawrqemftzgbdjueaxogjhdsclpkvaeyxfpxideslmpdtomljesfitdsryaeqduxkyiqxcgqrjdgmuscvtjfgbpxaozuhwgkyhmjynnpxrjfwenkaqvzidykhsyfsewqbvjacxontkdzfibnrqmndzodhgkumddfjiswrhasvzhmaxakxtokspauarzjlwajxettbhfqiqwpxyuipqhcpnxzvogvrortjgkddmdwmsshqrzmrrtxvjcgmbaecmahnyszzybeqvibecfjgjnuqfrwimfggskrxjuymkuhukeporrxplgkhhdzmkfsjvwutnhoonrwcapvkxwuxutxdxyulaicoiqkpfxxstfblmqgfwrbuprowkwmrersctyiyntxwjrvcrujrmdldhzupicqtkgviexugakdfbnjcbqkxggpdlyjbvjndrcmaunzxohecngldpkvcjdejfsdweosapaftftacoplmjwsrdckzelkzsjimkvyuoalcmnmzrvbvkveaolvalspnxlclpwaeynuoxnnccptinakhjsjyzrfyrnoqcvzwclrujvbwujeihleangqmhfzzdntxjdfhuoubbgxkeoxirovwfvmxlxcudkpiakebevotaazpvofesmxppllpxtovibqghrwbxojsvgtsqyvpohnfwjkfwewxrwvzekcrxlhwsynpwtniyettdiynyrppinxcyakaapyzzqhbcuyvppejhubcmmzbjodmlctcrmdumggorxbblydhhkywggbzfmbftnjsjzrtlhpoemaxoebrfurvrjxyorcdwlyyzdvepnnwjffvoeetpceqwoardlhulchexmcvyhkmbvdcfmkmtqwtcjsxyddtxguinqxqqwwbkssmjygljdrwbhxndphpnnqeuiidxxmmgjkrlaiyznyyajqzrfxvuxqztihctvybtzyrvdkxiznvgsffdbwoo	["mwaqhhzmhcoaxkdaoncefcqlg", "pwmdpsxqxokasbqgysfwtzsgq", "vbrhyyicnxolarunmlxsjdagv", "gnabmoohcquofjillilnqljhn", "qbvjacxontkdzfibnrqmndzod", "zfmuudrepijtbbqswsmjegrqg", "vjtxtchqgzpadqhjvifadiyki", "htwvajiwqlwczahggzqlobofm", "wjgbmxcnhhkdpeggybdnikiyx", "zzcjraadrmqepzdecyltdcmfw", "zqccblfjmhdgnhfawlviaoslc", "nidfwawzaeifqkezrxfscbepi", "cpqxhdpdpvozvuasdaxqhnqxu", "ugqxuylrigqhjzyyqblzajaon", "jhpjenkyjpjgbnrckzxcdtrzg", "ztbqstgwurntznorcnmiwnlor", "zuxhpwohhmgivtbjrprgbvcff", "fygtzvvzcybpkwrcaryljpzpn", "jemftqpaalcjcqjdtdkjihyuw", "ndgsulnptcrcgyxdoxfmvesex", "mgdbobuklpgchrporeeztugyu", "heroymfdxqsqztdqrafznhgve", "chtnlerwffppipvusoivoqiqb", "urllikazolwvozaytyfnqvczk", "hbqbgsqkjbsalynhjfqedfoqx", "hwlndkvconevifpvthgbmkzdo", "wpvnpzkpujepjnomxwobzmmyw", "xuvwpxaavjqognkxtvermbwgp", "tizhqxwgpqxmdmwadyjqzvryh", "akfdrxadswohmbodnuiujdjup", "dmqroywafqaslveeqizwcneus", "haxwvfeoqwxnjfluzdoghblmp", "npphaczjctvfxmhwsvnkehenu", "dszkhslikxcrzvnowfnpylcju", "hbgvuiivkfvdrcdtydzexwfty", "ysfvzqdgtpbkvbnflbklirkjy", "qhrybewwoszyzhxitxxjjpbxl", "ozxkbgbynkwvsibroahvhurfb", "ozlcuqsrwcqvpejidyifxzphh", "ehbiqauodtajawxtwwfxxojut", "rmlbtngfwvgksxotyonvfivxi", "chzmqootjnzfxdpumjjfiihbp", "igszncxvfaxppjdoovzqzuufu", "rgsfoqqkwhsenzmdqduikouju", "jwnawzrgjdsqhcbrirkqyvbfq", "cezqtagjqsbridgebatdcdrxr", "eefmfzoixdtblkauddrzhqjth", "gkwhuwodkohgxjkfbquyvznea", "kvaeyxfpxideslmpdtomljesf", "uskkkvjyavgqiqmljhplyiurm", "frwimfggskrxjuymkuhukepor", "ugrbuvvynpihxtddhfqductkg", "ebzbkcwlniazxourwhamsazro", "umhdovhwjewqmqvzcsymzudwm", "mojonrwvrpcrahvjwbhnynrfw", "gtxsqcmlaftqygdxtavxxmzdl", "smiylteqfbxdorqpbfmrjhnbr", "prjsgvqlmcsmbwknhutbbdvum", "tbukqmzslxwqvdtswicqvuhlt", "wuripvyiyvpbagyfvbqqkktnm", "jmyxqnmjqimexwbduxmbynweh", "ddcffvoephvyrfenaugsuonzr", "zlzczucgurptkqdmcbaraydcx", "gsgrzctrkpyfptttdvdphwxbf", "orvajmexplmnjtbofiabbagir", "bljvoduvgsqdhmosaljonbtua", "evdnxirfekcezrfybgnfbftbj", "gffiagwktbayelshouphyuejp", "zjckxgirogxurdmfvindgvakd", "aifxeoxsohikixmihtcjobrdi", "pfswqaiitokfbbobidzfleejd", "ighjefvjvbgkooudwyufejxki", "homsxshqmyoavfxemaqmehyrj", "bjncjpdlinfgmidktgxylyrvq", "emxicjrrudnpdpahxafwlkiqb", "sxefjivnddkoqmnslsdnpczaf", "sbamuejcthjkbjlosuswutxgi", "wrqemftzgbdjueaxogjhdsclp", "olddxfwvmztmxbiqzxslflmtj", "drehmlbpdgmmfhqvyibdosmfe", "yctjivaylgenphxldumxilnol", "wplzaxgsedqjnjxzmkuqasjaz", "khnezgnphlxypohmhgmdvjceg", "ihcuxrboyrnpczfccwgnpwaxo", "ddmdwmsshqrzmrrtxvjcgmbae", "wpxyuipqhcpnxzvogvrortjgk", "qnvbrqjfpayvuzknlleemmrsc", "seaemwauhirbfqjimylfwqpfk", "msvkdgdzylddjzyczpqlyjuzs", "ehfmwytwsfurndnjwieuquumq", "jhessdjxemeugdvylvtzirerf", "kchfehzmddnnmpndqqoiqqkxi", "dbwhhybfahlnbabsvtrmjslbg", "spdlvttxdanoodacsbemxzvyu", "gcejekeqjoquazifkgyhfiqwx", "ggetmazvbzkxapbqbsbwrszmb", "crzbjupfbflupehqwztgrgawa", "srensghqwfviagrdgtpsyxmrs", "pmmyyqjkwxmuflcazlcrxuzug", "ighdvqbofvwalavyxxtzipjws", "ripsarmizubogcjayhjwmlfft", "oojghczncjirrbqfogdixeahi", "jhpohlyyptfuagsztqzlracbh", "eqxvwhxjaaoznhfthdqhvqkxp", "ryryttpenqddqufnkzzfqrrom", "kyayhtpcbgzllztmlxpwsqsmr", "cbkreqzcouvesnzpeohnfhwnx", "zzvhxzyfazewsucivjruohckc", "njtendobiprqaazkvvrapbvnj", "kkcovtqthirrarkalesyjntda", "aunivfbsmptiaemxtunhhjfmw", "qcphukfnlpdywuriakjwrwiqa", "gxfbxiusnbwjsoyonqbabxrgl", "tinapzanipetckaikhvobxehp", "uvnriidyjgcnuiruozozivhuo", "yyrtfphuibzlctizdipzasfth", "gcczoewfmugwijzsppcbvxahz", "ewlitcdyxonwlmaqkmigkjufr", "rykhppzhtmggwwjipzzkfwenc", "zipbuggrrqxobkrmbjctoakqe", "khypeutqisxxlsfgspnlvaaqb", "iahdkaumofidpyrgivsytnmuh", "zuvpcjnyrutwmvhwyvirlizda", "rzqjdehswulnvcynsvehzxdct", "sgcjffkarkbsaqrkssxzlcdnr", "npxrjfwenkaqvzidykhsyfsew", "cxxhoivjngogtedljqsvuoens", "ctvpxenbdsdypfeabpbgpoang", "tcytahdrqurdweojqdpuwwurl", "tkbrcbhltjibsigfirnausorx", "cwdnzseykdicutymsbinbppxk", "iodktkyalafiydmfcrbrvkraa", "xaacepgberoajglkzprakkldj", "gpsxlfbisnjcobopfkvrvqvsl", "xyhtjkfirxzbjjmnotwtucweb", "ppoejwbzyuqnwubaheikbxwyn", "tokspauarzjlwajxettbhfqiq", "ekjpgjnvmsrzwgkhbvjyybtor", "odfvquovuamozueelyhuwurjp", "xhesfyewmolceyaczpaimzmqe", "eycwxcoxmmxfifeokwuskioxj", "wqpfmfggffxaqunferhhcixgj", "hpajkxonusylspwwfzyyxhord", "renspthepokghfknycnnmqsav", "vfbryeykiymysbskjrrhlaqmp", "itdsryaeqduxkyiqxcgqrjdgm", "wcwwmeungfgpliqgogryfbfdi", "sidiplhtzpyhddpmxqxqsjwdb", "ctxningonqzvszltwlrmqfyby", "exlzmisqqssqlhqgjxruxxolz", "cmahnyszzybeqvibecfjgjnuq", "vhvhhnrcqfakzkxqhposutakh", "rjugvtcsdubnktlytutqghflz", "sexcpsmbwrrpzmljxlhnezitf", "yyhuajbnrjuimxqobsvvobroc", "lndtyivjqtsnzfqhapibxgwtm", "nhjtdcotdxqvubskwzwggubxy", "ufjarejowiaadwlerpvdzjxzt", "rjtarjgfelsdxcgdsayxzvaff", "zajtppfdggqsdwewvepvffopc", "jteekajtgaedvbgdllnrfqsmt", "bfbssvfkwkjllskqmwsrpmjhm", "uscvtjfgbpxaozuhwgkyhmjyn", "yrixvzyvhxqxfvltzwctxagei", "zppoaqkgrmbmsghzvzajlddaq", "tqmhomgjhwuejrvderrjdubdp", "tdqsgbmdrfkmpeaxgfddbqnxb", "mxkjrtuenwpalijltzobmblzh", "hgkumddfjiswrhasvzhmaxakx", "ogwneggtqwecmxhbdizhvuhki", "jyvxlaenorlovhbttlqdvuupp", "pfcxcpbydpfanalbpvymnirah", "fvboreqbgrowqvcgzhrctlvdr", "mzliwavubzclprrxcoxaqgujy", "txhdgfebmhzxnckzxzqzjucok", "rfpqnhiolkaxufwppkfbtkqmc", "lgegdecqgbksbvjscovyejtmv", "bvezuhlcmqxkopsgpymrewjij", "sunrwygeoisztvhrpuvxkbzfg", "wasitzauphlzjduydpehyycmo", "cnqzukpmskigakocomhyygmfj", "sjqlzsmunckszackgmlospyoo", "yiyzktitaxeszadidrdkrtflp", "rrkoehispojvmxkwhapircdae", "iuuilasxpycvxtnikuiuuufzi", "hrativkswomcxzhbjvvvpzkpu", "mintrgzywakxwstrnphgckegb", "befxeaeyihfjzmrrdqubpqajr", "ltlabqpgvnbtxsgphdumpnrnp", "eqrgtbltutjayltjdxqdiusia", "aeqmnlganhmzauiapdzegxbaq", "qjlvfkcezqcyuvtmomsomkugd", "ndaomvakroeqlqgsqtulpragp", "xyqqqberzxonjadzhmevtvaxx", "glvljyqbihmonciqnnvxownib", "bggygvbbhpiydbqgnxbrprsox", "vxovmxukwuzrstudrhzpeorgb", "cxikoqglpftqlvqycusjudxym", "lxtvnhiqdwlqyndfdrvxrrnmp", "iuvgploxsjallyslswdwrcwct", "ukniqvojmpqgkzqhnbafffcyl", "arseorcwglzeprypwfmcvaftq", "wfgpbnyocctvsyydtqklbapum"]	[529]	TODO
bhbfiqztyppagwlrzfkxuukrhkotiobtibwrqvgbicafcxmejbczvmwcsoujbuatvapebcwiarlgybukbgozfokybxkblrtaferfmqkugeirkznwnfpjnoknedxyiptwozfvezsuvckxftnjblqnxcgnsssczqcmelzgpgcmdjagnddnfmgitqoqnuokdgwzzzrctptmgyhspprnzwokqwtvohuqaxlsbtttfvxutboepdjtdhcjzxzijmupoxgvpedariezqrakczcmqrilffilkpoasjsgldbrsllntacomrvxygquuurxjkdmwfhwzfqhhtwwzcagolscgrhmejulwnmljdldpiutrutbggyczdutcjxsqkstibcndmmacphpjlgdvxwjtuaxgfakzxmyxtmqqigofrmenfzdjgwxmryhmtpypzoblpqihwgorfazosuhhabfdeowbbgpyigzhwdalakntqsdrauskvdhanzaxtmmrhymgvuzsawtylmjroccmwlonowhdsyjfuquwfbltwcwwtjqfqoltaxpkxtgxwecuizukhrjzzjvkceyvazddbryxpudprwsuvaxcdukuzurdxbnfhivfunjsylvjlpvuwlheavqbmpkagttxrdjfmnekcrwmlopluryeeslwzfarwzhrxkjvilxxnnoqemcrxkcqeinvlhelxpryaotvupwywuseotclmrtsvoooqxazldxaqzshtwxtxamlztkfzmyjgqzkhmvpekbiubdfwtbngmcnrjjlikjfjhhedcahmadpapxafahuvlekslftdebwpydrwqssyfgtxsztuxysrverugznpztcxszrngxbostemdbotfuprrwemvjhcaepuawfmnfvxbaadukbqaggdpoemponwaeadeiliwapwewdrkkgqoqibywixvunlrfhcwhxkmlkwlhrfvbjbntjmiqayhdzszxtpbpoivxcaboczvqzkuylgbaxhqbyexwxupkzjtfpnndkkbpdvryqrczmazfnmfhorzmodkjiqlsjszlvlhfnlarxmcgjlnznwyedhwlslsmkpbuofqeygciyrdkniuhjqoksodwxemrxcflsbfyyseoxhxgeknscdeirhmdoijwnlersgbyzwqwzhhopwuddnwtbmszqmvzwawbibydwbepyobropjxljplqvppgicggcgfcaztuaftwevuuhdrkrqclkyvbwigjkuxqbpfuxwxqvkynybtbrxstiotjyeqpqhdrtpegpnljihxkhpwbswtjooqcxzyhqvspiechjiftdcipdcpfjewgnqeyevxcjrdntbsncdzbmdpewjhjszfrlpbfiusrdfzmfgxsubbodpxefblyhyizriaozuducxosjlsvsmmdzahrvgiqxqehunijysvwujwvmsjmbilzzpbcciuzurnkgosappxmgxpdayeaedmorifprcqfpvgqmhhhtjywvrylbvxlnaohgtnwuvysjarqmmlqigcgbkzmuwwdaoubhesjrfcutofqvgpyreaxfsotlosxsvagrueyqstuvwfjzxkscqawtktcxqvresbiaewykitujwzfruyohiowmhjabydehlscyswhjcccjdlotymllvewnbundnjvcihsjygtkduwguvkipejmybayvhoekjssfwcuguxvkainlsoukppzhsncgkspwspfsdnytgtmbrusasaqpmltbtuyiuniolwuhnikwasbeajnaozbvvnzdyalihjhpjtnaaiaecoghpsiipiymorecydauwmmmqrvfvlphxqrbtuieglljtdxszfovkvgtliwojpcokppmjhkdpelkgqltmodssvcsycueyhnprehopgqcuijiubapotpvddposbnffgaiviziekrnsaavolmbchpwojovcdrbodibwftfzvjgbzioonvgbiponjmokaouqhvcaybsrjgrfektcultpvfwgeapnwsvhodjndmzwflyhesenlblodejhnhwnyvstnmoicijbjkhllocdzcxxsujxcbglzhclyybsecslbgdwcmdfnicqhqherrywmkldpseucdrcotcgrsozcgleszhxsuxbaqdbqhooukysilguwcbjdwbevhtocpoglxhtjthgmxztrnyqufurfuircakrmasbeytwlwpbxinyvbbweurgwpwjwdvmqpmjqqjtqgngezarhaxowfjknjmrwpxccurofahbjwywzjrqpfdpzwvkbpcwcgtrmvdkwvkjvgjiyvuxqqllcodnbbtqyapebaywsgjvntymyiabuawykdssdqtvhkrhrjhrfeebbviyypecbfkwvllxitwkmxzuurfqcprcioskjkjjzwbclbzbtgsrspfolvfiimxnvrthqnflnkickfqmutxakjwehhbeexcrdxbbyewshmtvkugnfmhhqgplxpdclwzhxhyioyjqfxeglplyzhxexsedvzsaggcmnwtegxixfsmyzmacdejidllnpwfqplaeezfvbklelbvomshedebpdbeawzhzpmaoytsdjwgsstpbtnwsjbpwbursjsphjbtdrczainujomchrcfotnandfqldkglsefnmafchqrcrzlgegtbszrdrghiznjgcestqyosbdiruimnfqxeefzqoqumzzfeaybyopyoulekbktkczhmaqnkpdstxybkojgwhrujqqbrcqqalsunneqehtjmbjsonzvbwwcqqcgoaskxwxhqcsikcqsqawfhzqfzqllojpbpzkwvnhfogsaktxihxwubqcgpjvjqijdybdqnvmftjtjngnmmnojzyyidntbuxlixfugnzoohhgmasjurgvlrnjtzxnjycnibfknaremmpcvvrskwpexkwpvnezjjwtjfmuiuqnzdujakiqdymtpmfiuhdvfydeowrzupkbuateqrmjbcrgqiehdzqvrjakbyvoxapdkezcqyqrkgmcdklpptcwrgdrxnkdfvphateglcsedbbpwstotxavsqlapkqxudmeskpwjvdlzkvveyjjiphtezhuvwdwdeeddxykwpezaxirinaxecpgetmrtwrbftdzhppztutzdasbhoxogltucreaqiajaqhmknfmfwfzayzicwhdlknctjgunjvyrneqppaxpiswlpijzewphrywarodampdaximbvapyxzzbyfzvdtnjwnprerelkznryrrnekscvhcqaeecmjqmoluntqqckpogwkbfymbqyqpijxxtpyrbzfxkjgbbqpycaybtdbvprmhooifbemjolorsjxsrshpaoghqycdmnpvfhnkpawbnorrgfnwemztvtkewjhsxnocwebpqmpzzswqdnqzaeklmddskobnfpodapayhmnnbtvkzfpszasynffinfvinssfzxunaepobiuhkshvuytyvbwlfubiomwmaorlnwxxmkmbedvxoemsemkhowkwskjoraxzuysohbookjerssxkbqzvqvvqazyyjmrvexmoxgmtywzflwhbqnzvdcecdzlwynuzgpcmcnrwtlftlutcykfpbgfknydssnghkdyjmbmxldgktlbsfepfvxgdmofjdafyqvdavleoduamrummrhkkbpgimonlwjhqzvgcuuynwjrqzxxwjqkjdonlbpkwyvtnmlvpunexaigmzsmfnlwjotmokwvpvywgzucbfmotnjqwiahunzvelgafplxchndqesxgjelxstnjzmvsgjdzfcrxidvdiaiwxogvxvlaeqoanjxbcqzsobugdbalavwempxocrkspuuwvewfizehzqnuqdufnxpusllitkckngdkvdzyuoxmyhpmusddranaatvhmdvaoxqstlhhajdjfrtqrmigoajkhyvdoicwpasdagudynwpzqklnsgfoyhianwwackwhedmvnlrpekcmdixkecrpwvbtvshylhufoorfxgaqppruffnzshisctcdclpjzslmvnkwbqcpkpsgxrnxsorqhzbwogjizsqjribruqlaewbcxxzrebgozyaironsvvmkyicqoigncgvvstlktgrkremfnaylbkeymmwvnpkuqobnhsiwzpdbxefyruzrnabxpmkeherwnrnwxvkmmymozdclndtzqrbdxwhbfsbjnajfsbdbyeoahyxbpzhlshhryuauavgysyvwfnbvcpllqnlewzylrunbkfpnrcmnwgnhlnnieqbczsmvgeosqfmtzzplehtdnpvqkdxfmulgowqifycjptxillbygnplkjtdwgvmmvdzubyndwxrcyvmhgensaqlouhomnpcdrfnrppcpsvyfjeoyffyimhhpxihyheomhfunageutgtnvhjqvdugujtkrkpmdjivwpkacfexujfsdenxhfsclcitihnskaodbaqnimyhcuybrmxsdacdznsdbrfwdndefbcwckzrrnagxfytiwmdtmgnuurrdjivixontihzvmqkkbiswtktropebkidsrrchkulscootdamdpjyewstvpbvacxxohvczbizczixapoqczmszbqcpqfsairskwiowriilqpxdmgwyfsnftorptnwahsnzcepowfacnemavmjqiobawrwthsyrwmbikgzkxsjylitannhaefdemfiyyejgkjedyugioywxwidtovhrquixqqibitfsapfcsurocrlcufxlqbnpvulkfjklazwdqdbttafuyhziowifbaxglxofurglbghqadvgcxmljfjphnxdyfahckazqjvqfqpijcenzsqhyanuyhtoohigzgnkykcutehnspgpvwnnxpfmnbzfdyuxretmhopwnnrqkwkulifrhpxspwdryrdiimqkvdlkctjjibzjiaalwewzfyspjfhtelcafmnsrumuphphmwgjkphzxgtuokfxesfzbjgagyecuuepoogrbxsubtlpiglmzgyhermubwzvaocwwdqmcnoqpukymfeyuvxqeahwurveeheeomkyrubskkhbhpyjmcxwgjkmuawqifmhdbutvucuxlujuqtpagobyuctljubkzyyhischihjjttzuailbysdiibbrvbccykewkmzmefqbwevamaofunkhxwswwiifmbfsjrilmxsjqooxwscxrjbhbmzmcddreznllakbeejcxhvngdybkehlkrwiiduwxdlrteajyzqmqkawgcboshuwmumqnpqyrtbzbvyyjbeaktapaaiuipxqjovxbejumcbmhykeehnfshruiukqmrvikjzslhaweajztwabhdfyumizpjlyaalqpotothomjpynocnqwbwocjmdcboguowmwqvclbnspmritzuqyxywveyfenurfaafysszsrhgxmezfqluhzunatbnopgnbbiysjxmujfkcpvlkaazslkujsfhvxwvuinorgveeqhsktwdhaafnqcxnsbkamxlcyapulxqqmncrnsshxybhsxmwoluzxremyapyfdbdicjatcipkirezukmrngfzvlrlujhrjuuqgwodmjytopklasrhhmrcbgjoyfdkqttkihyneupamaxvxfqblpqlnrxmmtwruiqgkmshpvizsvjarrotwfitmontytztaelqwlsooiipytwbzuqgcuenscofxmbfswmllmouqzswlwbpurchfjwfqvpypzuzzzzogmskyskzswqonaijoilfgounmwkgzvctgiixcmbibqzxfdunwxbpevlwpkpixdublpujyvnydsmzfpkflsrdpnyjirrvjfzjxbqmvvexpwbavliawvtoeshwrsvoyjpicktdobtbsqopiywintzjtqiztyisldimgaejomivxhmoxbhhnqepvbtdf	["eawzhzpmaoytsdjwgsstpbtnwsjb", "qiehdzqvrjakbyvoxapdkezcqyqr", "xsdacdznsdbrfwdndefbcwckzrrn", "ywsgjvntymyiabuawykdssdqtvhk", "awqifmhdbutvucuxlujuqtpagoby", "zgpgcmdjagnddnfmgitqoqnuokdg", "wjhqzvgcuuynwjrqzxxwjqkjdonl", "eqpqhdrtpegpnljihxkhpwbswtjo", "uctljubkzyyhischihjjttzuailb", "ewgnqeyevxcjrdntbsncdzbmdpew", "tclmrtsvoooqxazldxaqzshtwxtx", "gfnwemztvtkewjhsxnocwebpqmpz", "heeomkyrubskkhbhpyjmcxwgjkmu", "xsubtlpiglmzgyhermubwzvaocww", "ehnspgpvwnnxpfmnbzfdyuxretmh", "fhtelcafmnsrumuphphmwgjkphzx", "ywmkldpseucdrcotcgrsozcglesz", "mlqigcgbkzmuwwdaoubhesjrfcut", "fxlqbnpvulkfjklazwdqdbttafuy", "cmnwtegxixfsmyzmacdejidllnpw", "hzunatbnopgnbbiysjxmujfkcpvl", "pmltbtuyiuniolwuhnikwasbeajn", "nwahsnzcepowfacnemavmjqiobaw", "fdemfiyyejgkjedyugioywxwidto", "maofunkhxwswwiifmbfsjrilmxsj", "vhrquixqqibitfsapfcsurocrlcu", "fxgaqppruffnzshisctcdclpjzsl", "byfzvdtnjwnprerelkznryrrneks", "zubyndwxrcyvmhgensaqlouhomnp", "rcbgjoyfdkqttkihyneupamaxvxf", "ickfqmutxakjwehhbeexcrdxbbye", "nscdeirhmdoijwnlersgbyzwqwzh", "mmdzahrvgiqxqehunijysvwujwvm", "oksodwxemrxcflsbfyyseoxhxgek", "uylgbaxhqbyexwxupkzjtfpnndkk", "ibfknaremmpcvvrskwpexkwpvnez", "yfdbdicjatcipkirezukmrngfzvl", "jnajfsbdbyeoahyxbpzhlshhryua", "ywzjrqpfdpzwvkbpcwcgtrmvdkwv", "rskwiowriilqpxdmgwyfsnftorpt", "hyheomhfunageutgtnvhjqvduguj", "fotnandfqldkglsefnmafchqrcrz", "aozbvvnzdyalihjhpjtnaaiaecog", "zewphrywarodampdaximbvapyxzz", "tbngmcnrjjlikjfjhhedcahmadpa", "vddposbnffgaiviziekrnsaavolm", "bqzvqvvqazyyjmrvexmoxgmtywzf", "sjmbilzzpbcciuzurnkgosappxmg", "mqkvdlkctjjibzjiaalwewzfyspj", "lscyswhjcccjdlotymllvewnbund", "cenzsqhyanuyhtoohigzgnkykcut", "cdrfnrppcpsvyfjeoyffyimhhpxi", "rmigoajkhyvdoicwpasdagudynwp", "mbmxldgktlbsfepfvxgdmofjdafy", "agxfytiwmdtmgnuurrdjivixonti", "jywvrylbvxlnaohgtnwuvysjarqm", "ifycjptxillbygnplkjtdwgvmmvd", "pkagttxrdjfmnekcrwmlopluryee", "amlztkfzmyjgqzkhmvpekbiubdfw", "vczbizczixapoqczmszbqcpqfsai", "oonvgbiponjmokaouqhvcaybsrjg", "hxqrbtuieglljtdxszfovkvgtliw", "fqplaeezfvbklelbvomshedebpdb", "pwbursjsphjbtdrczainujomchrc", "kjvgjiyvuxqqllcodnbbtqyapeba", "ftjtjngnmmnojzyyidntbuxlixfu", "qihwgorfazosuhhabfdeowbbgpyi", "sonzvbwwcqqcgoaskxwxhqcsikcq", "gtuokfxesfzbjgagyecuuepoogrb", "hmnnbtvkzfpszasynffinfvinssf", "agolscgrhmejulwnmljdldpiutru", "czvmwcsoujbuatvapebcwiarlgyb", "jhjszfrlpbfiusrdfzmfgxsubbod", "bejumcbmhykeehnfshruiukqmrvi", "xmljfjphnxdyfahckazqjvqfqpij", "lknctjgunjvyrneqppaxpiswlpij", "eqoanjxbcqzsobugdbalavwempxo", "zxunaepobiuhkshvuytyvbwlfubi", "hsncgkspwspfsdnytgtmbrusasaq", "zmvsgjdzfcrxidvdiaiwxogvxvla", "sllitkckngdkvdzyuoxmyhpmusdd", "sycueyhnprehopgqcuijiubapotp", "gxbostemdbotfuprrwemvjhcaepu", "lwpkpixdublpujyvnydsmzfpkfls", "zddbryxpudprwsuvaxcdukuzurdx", "izsqjribruqlaewbcxxzrebgozya", "otmokwvpvywgzucbfmotnjqwiahu", "gnzoohhgmasjurgvlrnjtzxnjycn", "ztuaftwevuuhdrkrqclkyvbwigjk", "oicijbjkhllocdzcxxsujxcbglzh", "mvnkwbqcpkpsgxrnxsorqhzbwogj", "vxygquuurxjkdmwfhwzfqhhtwwzc", "opwnnrqkwkulifrhpxspwdryrdii", "qblpqlnrxmmtwruiqgkmshpvizsv", "gzhwdalakntqsdrauskvdhanzaxt", "hxsuxbaqdbqhooukysilguwcbjdw", "creaqiajaqhmknfmfwfzayzicwhd", "ranaatvhmdvaoxqstlhhajdjfrtq", "yioyjqfxeglplyzhxexsedvzsagg", "owkwskjoraxzuysohbookjerssxk", "rlujhrjuuqgwodmjytopklasrhhm", "bnfhivfunjsylvjlpvuwlheavqbm", "uhdvfydeowrzupkbuateqrmjbcrg", "kgzvctgiixcmbibqzxfdunwxbpev", "crkspuuwvewfizehzqnuqdufnxpu", "fgtxsztuxysrverugznpztcxszrn", "qvdavleoduamrummrhkkbpgimonl", "wzpdbxefyruzrnabxpmkeherwnrn", "youlekbktkczhmaqnkpdstxybkoj", "deeddxykwpezaxirinaxecpgetmr", "ewykitujwzfruyohiowmhjabydeh", "bevhtocpoglxhtjthgmxztrnyquf", "hziowifbaxglxofurglbghqadvgc", "zogmskyskzswqonaijoilfgounmw", "eejcxhvngdybkehlkrwiiduwxdlr", "bpdvryqrczmazfnmfhorzmodkjiq", "vunlrfhcwhxkmlkwlhrfvbjbntjm", "kremfnaylbkeymmwvnpkuqobnhsi", "slwzfarwzhrxkjvilxxnnoqemcrx", "sqawfhzqfzqllojpbpzkwvnhfogs", "sqfmtzzplehtdnpvqkdxfmulgowq", "aeadeiliwapwewdrkkgqoqibywix", "xpdayeaedmorifprcqfpvgqmhhht", "wxvkmmymozdclndtzqrbdxwhbfsb", "stuvwfjzxkscqawtktcxqvresbia", "caybtdbvprmhooifbemjolorsjxs", "gwhrujqqbrcqqalsunneqehtjmbj", "bweurgwpwjwdvmqpmjqqjtqgngez", "kgmcdklpptcwrgdrxnkdfvphateg", "uqaxlsbtttfvxutboepdjtdhcjzx", "wlslsmkpbuofqeygciyrdkniuhjq", "zijmupoxgvpedariezqrakczcmqr", "ukbgozfokybxkblrtaferfmqkuge", "suvckxftnjblqnxcgnsssczqcmel", "xpkxtgxwecuizukhrjzzjvkceyva", "njvcihsjygtkduwguvkipejmybay", "aktxihxwubqcgpjvjqijdybdqnvm", "ouqzswlwbpurchfjwfqvpypzuzzz", "veyfenurfaafysszsrhgxmezfqlu", "jjwtjfmuiuqnzdujakiqdymtpmfi", "tbggyczdutcjxsqkstibcndmmacp", "iqayhdzszxtpbpoivxcaboczvqzk", "ipytwbzuqgcuenscofxmbfswmllm", "mmrhymgvuzsawtylmjroccmwlono", "arhaxowfjknjmrwpxccurofahbjw", "whdsyjfuquwfbltwcwwtjqfqolta", "tlftlutcykfpbgfknydssnghkdyj", "lsjszlvlhfnlarxmcgjlnznwyedh", "rfektcultpvfwgeapnwsvhodjndm", "tkrkpmdjivwpkacfexujfsdenxhf", "bkfpnrcmnwgnhlnnieqbczsmvgeo", "omwmaorlnwxxmkmbedvxoemsemkh", "wkmxzuurfqcprcioskjkjjzwbclb", "zqklnsgfoyhianwwackwhedmvnlr", "rhrjhrfeebbviyypecbfkwvllxit", "sclcitihnskaodbaqnimyhcuybrm", "wzzzrctptmgyhspprnzwokqwtvoh", "uavgysyvwfnbvcpllqnlewzylrun", "hpjlgdvxwjtuaxgfakzxmyxtmqqi", "gofrmenfzdjgwxmryhmtpypzoblp", "vhoekjssfwcuguxvkainlsoukppz", "epyobropjxljplqvppgicggcgfca", "clyybsecslbgdwcmdfnicqhqherr", "wshmtvkugnfmhhqgplxpdclwzhxh", "nzvelgafplxchndqesxgjelxstnj", "rtbzbvyyjbeaktapaaiuipxqjovx", "qooxwscxrjbhbmzmcddreznllakb", "ofqvgpyreaxfsotlosxsvagrueyq", "bchpwojovcdrbodibwftfzvjgbzi", "pekcmdixkecrpwvbtvshylhufoor", "urfuircakrmasbeytwlwpbxinyvb", "kaazslkujsfhvxwvuinorgveeqhs", "ysdiibbrvbccykewkmzmefqbweva", "aalqpotothomjpynocnqwbwocjmd", "ironsvvmkyicqoigncgvvstlktgr", "lgegtbszrdrghiznjgcestqyosbd", "cboguowmwqvclbnspmritzuqyxyw", "zwflyhesenlblodejhnhwnyvstnm", "kcqeinvlhelxpryaotvupwywuseo", "lcsedbbpwstotxavsqlapkqxudme", "zbtgsrspfolvfiimxnvrthqnflnk", "ulscootdamdpjyewstvpbvacxxoh", "hzvmqkkbiswtktropebkidsrrchk", "hpsiipiymorecydauwmmmqrvfvlp", "rshpaoghqycdmnpvfhnkpawbnorr", "pxefblyhyizriaozuducxosjlsvs", "irkznwnfpjnoknedxyiptwozfvez", "iruimnfqxeefzqoqumzzfeaybyop", "hopwuddnwtbmszqmvzwawbibydwb", "pxafahuvlekslftdebwpydrwqssy", "dqmcnoqpukymfeyuvxqeahwurvee", "ojpcokppmjhkdpelkgqltmodssvc", "bpkwyvtnmlvpunexaigmzsmfnlwj", "oqcxzyhqvspiechjiftdcipdcpfj", "twrbftdzhppztutzdasbhoxogltu", "skpwjvdlzkvveyjjiphtezhuvwdw", "jarrotwfitmontytztaelqwlsooi", "awfmnfvxbaadukbqaggdpoemponw", "ilffilkpoasjsgldbrsllntacomr", "teajyzqmqkawgcboshuwmumqnpqy", "kjzslhaweajztwabhdfyumizpjly", "cvhcqaeecmjqmoluntqqckpogwkb", "rwthsyrwmbikgzkxsjylitannhae", "ktwdhaafnqcxnsbkamxlcyapulxq", "lwhbqnzvdcecdzlwynuzgpcmcnrw", "qmncrnsshxybhsxmwoluzxremyap", "zswqdnqzaeklmddskobnfpodapay", "fymbqyqpijxxtpyrbzfxkjgbbqpy", "uxqbpfuxwxqvkynybtbrxstiotjy"]	[50]	TODO
lksyedsbbhsvejwftllomyfgobiujbysbffmmierdjynyigjtmwuakghswbrjxxrshgrdntgojfduosptqptgyfpbthrvztjlwlxryhggpmguzyivomdlcytggbdelhnetmysykcmfwmecurkqknytpkegayqhyldnrbyyddvrhrjotmtcxsqkmgamemrcovpxsouhbvjkyyxjnuumjqfpjxufcwwuzjfdwlixdvqwtblpblvemlbyshukxzuklluemigjhoddkqwomzfzrzhffofsalmffmlheqejtkbcfqnivgmyvykldgbgqejhfsnlzrsjwukuqvbllwvacegiupwqcdwzcywmifpjfijshvbppspfxyyxscbkpqifnjhcilkyzqlfdtwygsvoqtppfgbeslnobcnlpvkjfdiqroukrvxnpkiwgltcfznwfuevvyfarexifxhulwnzypbezlourjzajbvfmgqdahzfwlqkkfppvgccjvcfxffiwgyajkgjsriguwdkaybvknhqknhgqywakblqhqpudgdnnfvnuhkvbjgsozpzoowxkvcjgfjqosfjtgopixclzyblofwyccabhpviwqwgzacmgkuwqcevxsnzirsgobprlcokylaoltwqpwarovwzxrjvirnumtrhggjuxoosdfytuysoiqavnjytgztsosecighvivxzdumnzrjmnsfnyuzeymmdzftmsdqaubydbnaqwsperwviwcshrwccugkjmljmtljglsskvnyyrixigynnbipbrbvdixsmorshfrslrqrtelfnkxuhrckidezyddnsehkdmjggcnrjfumdfjbdkhpnxmwmsyrxgzosnciibsnyjjwptmttrmzatssdlxomkywnmopvwiilkjzpzoqbtvbmxujsxwzfhhqwvrpthgyjchnqvqzbgqebxqvbutybgkmnrvpqdopzvivyepmnrfhlsozsdovfogxgdksgmnvqcyahoosgckjkjnjsjxtzbvvcrxygmiskjsjzwrkowqjdxyhinfjhaxuvpwdvmbetvgoynxdycorwlmsghriiaibpoiizahoupryideoimgshbrtuixitrajxtvkyojzulhpqouvygxgplwptngjextdviapusjupeprfpyvyudslvnykqdecwuhjdlxhbfljrniozcfytircppbvymohxkwonnrbxnvlubhpdzoyqfmkwwwhgqvhlyrgztpnpcdcapqdxieirlccuxagcntzzseslssracoafigcqndngtpgupxbiugmjuychfmczycvoyhizipkffalvoibmrryrimmytrhjmozlrmejkybgepdfqtcdbmvaigrfaqcopfhhbmrhdjtvnylqjtjrkxvibtybkqebbmuatrczlgiletoqjzdjunvbpiupvwgslgsyknsalafaycmdxohxsmyaktzebrqiuzoktenwkgepylyncgqubaabtzmfhcehffokdjtuicpxpjmgcpdlpdimrebqsmwzclitbxtawqosptcqqtorwkfcrtemniuiyixfrvmpgtnejpaiqosdjiiffohqnoeznduwkmjgksuqnaexhxmwrundmhxovlavgazgmljxbxicjoewpgisgchbawenkuegubxxttbluazxbcddtpcefammrgxwdgvnzfmjrvbyufuszdiotdfkfhxaibwzztwjrlypuqmkojoaokoldpdqamqzeujbigvoxpufvmgqzpmdbyqcmxrmpnasahuiivnrcndomxtuekdszxnuirjgwjcwwcsssofnomoytdyhnretlezzznvsosxgnychgwhbgvxwknfvelpknxttmcltnsealsbxfkrowdltljpkbxvhipgelxcgtogewpdnikjoabaleznokueccuspxkrkjkrlpeggrbpeapkkjnmmkfrslfdogejbrltonwpemftjetqgpisiyxuksdjpvydtrzlehwtrnolvnsntuhfwwftqqardyvwickoaydezsnchoigsdmqrcenykvepyzgmtisopqllftctxzlsamfifxjdlftveeghocvurnldzyzkhwmhlidxvsmutnvhrduqzeqhvjbcaqscaraljlsfiwffrlzigzeridjsovkhlsuffuoilwrycavmlpuqmwlersjqxqyspypezuhewqixqbtmltpohzxjgipovjrcahhwovpllqhmzgzewxfxncilgxcnimpiyasgvdxaxwskvdwzonksiibrrnesosagssmohpowjwwfvikqpvpfbguxqwytxwwtqldwzhbdfqmdwfjodapcqpvsstlyhvozabsrkueffqqnhpsipdfeyamgysefjxejemfyqlvhmgcywkmsdhmwcpuqdvhofxznpuykatjmvknzkjdueozjaytdidbysqydgbugfosaxbzgrwgtfeaxpyogrekxazmfqjmszrsnxlglkxrggehycrkozkzzinermqxantnmrfowhxutghhyqjfvmetvrcygyugwtqacobjvropkraplswuyztihfjzvjvyadrpcxaoloungazqhbxggvwzagjnhfwcjcqevqxuimawmzdygmkoqyajesojtluupgecjfbuhbzrqypsdbwmmeplqacvlhvwirmvaercocmixvumhrtypmvkmoeorwqspijpoflrybjajjoelaprobzzkilymmfkkcbxzzahgshcwkhknazjbsnsulfxhsqokwzzsrlpftqnctkbttrqdvzdakmcmiuqjtvrbastyzyqmzwnmtfsikbireglslmyrqbxmuuaztmumdazwfdmfckuhaaelocvidfulguwwmrgjrrgaesfhogvsgwipjcgozgcrgothqwencndshxkehwmtbeqrshxlieuyxighmasvnbocrxjqlpetbdcniegltdvnydsdleugomtgpaszpmsfjkgvrjdbokhdnvggwgxlbkmdkwepaqehfaoujsszsuehraicgvzpwaywecjerqjaqyacfcxthgdqgzrxickoctlsqsqlzilvjqhiyrqgkjsdafotwmnxnltfikxxchfkttbsswpodnsdqvwugwxleujhkzzhfvsvivxapeozrvrdyinkomnxqozlahpfoaanujnigjmnfgauwdefjvspxfyxpmcaopnjuuudjmgpsqcxmhszmemcndvtsotrazfuzllnoqtesfdwpbcuovbsksaoeyqehorlcvdudyrcukophvcrydxzhjlxajfhwucovzmnhdbhneabwpmcwcxfuocuwzbizdkcrqbqjayovyvzsgqgyhotvvzppqxxxgwgsmswjglxkukmglbutvtiyofsibtkpbaawsedpkmcumvghogdqrynqvorslwniedomvckvvsvgxnppgyvnsvfjmayowrnikouvveyrmiucppqrogevnaxmldyukyirdbtnmjwiuwftshbvijytsakbdpsumnwshhhevmorapbcanozmdmzdxqqetgqzuzlsgnxsolbapngtjrnhgypokrxpkhxughjjsireyxuoxdntkalayzoyhpmsgtjjgytcjshdyosubbpobwhqsrkkhxmivyunsipeaavwhjwnrsjogwtppciaeuzytpwlxjkxsedkxkvloxhpndfttezbwjxondcqscivszvtiywudxcaswzaisimrvywujdsepjmxfuknweadslhgeiyqldddrknlaonpwxkuxvndznggdimnldxmfjjummlmyguhbehyrsrhokzccubtdykqlmxoisyjttwlimvjztegpbyqbfepurkddgbzpqnqerohgxweupatgyetvyqvilnzmbjnwoxtqtlouefvbfitvojrgctzyyjnfyangmpokzykpuwgfswlwdvnziyhxdbbechnrdjwrltoahcfejxzbftqrjtdhlcmzdjhltxurvjrskaqmxvwbiaxktmsekwbadafwxlcqsopoorzzwbgmcsxqwwaybprtpuokdnlcjzkyiioolpypdderrkpjbougjsdoogvzkehchevistqhzlmhauvisryyfwgcudmknybspsuddxiyjvxjvlkxvzagbqybmnsxrvyomwhjndlmnjyvbzlojqivsxjwjydlzrcacasilbkdkpkojlrymjiwpkckzidjsijkprczmhyxlyzhvbgqryuhphsxlhzbldszvnsqsfhcufurtgnceuabhhecubalcbehhqtubghsjhqaixcbxtuydeqdomfkwdsmmgqwxyqtgbzwwxqdvxwngdgcjobfsvcwnyijsrupjzjgatquuauddgibbayukqyukxxolmuhujtauenuvkanlihizgiisxbmpeywltxldkgnyfatdatqtgemooewtsdmmwaobmccftiuripktmfmsniwobcdutjqhsinwgbnvgatwptsurzjvmfqewxwotuvlivuyskickxmiuwiebkzwgupvxjmuogannuwsuonktjitdlccdxmffuasjmjwchwbhbuovuoixkfjnrkdaxmqfjzpzljfcdwutzsbzeaayxswlmvgifsridoqqybyeqwhuqktantrjacsospkinrlggojkkgwlvfggfeqqcncpiauupuipyyrkflkdqtxgvoxaxhxwbejdejdcxyfasuatakrjpahhhyizqvsyzrwplrfhbjcnxczjshtnhlcvvdpdkneteimuhhhnwuadiysagllzxpplyqxzxdmlyzlqlcxucmdddclxtfkuepdcrofabcfffxhowyomdsslabjyyjtckzazlfwpyueufmmadtoldwxgjieavhtwqtbmkxvzxrpbgkifpkjywiegftqgleumbhihwclnmzcstltxnaurtrkrbqniaukihinfggqskyvcrievivtfttafelwkaybhxcpozveiiwgomnmkengcpxzbjbbjqaeccskxjrvviamkdievtahmxlvizjvujwhkgsfcqaseawydspnatsmvpgcjhhxeqzwsfkuonjxlgugctqpxzkfxlzitgrhjixyyqtgqahmxhbwdzooojizbmxlsltyyvcblqzmxltiilmzrydqlzvpufzoomgdxytjumzxbmrlogwqvvbacopipokaylfuerxegndpxewyapkvhsndeipbkictyztphkstvhxqjdkotrmfxxqgkvtvbqifvqrofxnlrmmlhfcddkqoqbcljqdrbpdjrkwagrgkfslpzztrtuqvsyawndphwyecptiehwypgvxvtuyxvufmyqlyjwqdbgzgwmuxawkqzglmlriuyymhnhqjqbhwpluhokzhypzorwwvpoksdfkgyfcntuyjgtwipbaodzevbirgkzpaubgtyypowowvdibwabffqnlwpvkitbpidrxwckfjjnfhctfiqoyssrxaygijzqurlxtpqrncrgnoeqkatzcdcwgjuztznzbdklyguzyrvwfzngrzkoysleylphwtlmzdohxslnxurbzwthccrqnugrarmvshggbpiwdyrmyirhsbkkdwlarmvvdgyctuygcjuiayerxzxtgqcfaymrdqwgocydhcfueliurbyggawomocjgrffakohhfbuzwkbkcsynqkqmtipddkfughagrciudipvhlrdiiaehqggeyqkzhkrvnkzbczplmbphjtdvwkmulsrrpwhgymnzqyqrsvvwjixtfmikxeujxrlkppamnluxvqajdndbcofwzwwnizjvcbrlfvhgahoktoqzsogkyjwhgbhzqeiymsvcxmtmynxjhcdevmezzifraphmbdnrhkmrfadudojbvosetmboetgkjzfrrqtxlaajagxdbitsnaqymwdfbmgramtrimayolaoqjbzullkfopcgwzplvhlgdvwsnhwdclmkpaewfeutbhwqqsodehmvsaooilbgmeduvuzlwpyjgcpjknhysyzveaqhlriopzmhtdthtjewvhgwspivoqwfqapmrxwsklkpgcgvuuzroepebgykshlpcwnjdrydvptlgeudrpkqbidarwufxlvwkednpeachyptipwsmypejyvlhvowaqckltuwbajnwazopbwuxsrigywtilstonccpbxgbtfmtktxohxzvaxdrnzsgdailidyloktnfutdtucfxflmbggcriyuixaforjrrnrunbnzbierwkdqlmenecnorntqvuatkvtusztuxcyncvxpggiuzcocpnycuygkteuabtuygwwtplxyqvyvsdongfbguzlpiazatywrhibltrrvzirgzxlrbtnsoldklwnehyzumganavkzsyrdauu	["iwqwgzacmgkuwqcevxsnzirsgo", "jqhsinwgbnvgatwptsurzjvmfq", "hdyosubbpobwhqsrkkhxmivyun", "lggojkkgwlvfggfeqqcncpiauu", "ycorwlmsghriiaibpoiizahoup", "qrynqvorslwniedomvckvvsvgx", "qzbgqebxqvbutybgkmnrvpqdop", "rsjwukuqvbllwvacegiupwqcdw", "bmccftiuripktmfmsniwobcdut", "ewxwotuvlivuyskickxmiuwieb", "virnumtrhggjuxoosdfytuysoi", "bqjayovyvzsgqgyhotvvzppqxx", "nzrjmnsfnyuzeymmdzftmsdqau", "zykpuwgfswlwdvnziyhxdbbech", "ogvzkehchevistqhzlmhauvisr", "kmcmiuqjtvrbastyzyqmzwnmtf", "xwdgvnzfmjrvbyufuszdiotdfk", "wpluhokzhypzorwwvpoksdfkgy", "wyomdsslabjyyjtckzazlfwpyu", "sfjtgopixclzyblofwyccabhpv", "ztrtuqvsyawndphwyecptiehwy", "wgxlbkmdkwepaqehfaoujsszsu", "tezbwjxondcqscivszvtiywudx", "ehraicgvzpwaywecjerqjaqyac", "zcywmifpjfijshvbppspfxyyxs", "luupgecjfbuhbzrqypsdbwmmep", "jmljmtljglsskvnyyrixigynnb", "lmzrydqlzvpufzoomgdxytjumz", "vbfitvojrgctzyyjnfyangmpok", "ibbayukqyukxxolmuhujtauenu", "svcwnyijsrupjzjgatquuauddg", "lvoibmrryrimmytrhjmozlrmej", "vkanlihizgiisxbmpeywltxldk", "crydxzhjlxajfhwucovzmnhdbh", "kzwgupvxjmuogannuwsuonktji", "kqebbmuatrczlgiletoqjzdjun", "qrshxlieuyxighmasvnbocrxjq", "mnmkengcpxzbjbbjqaeccskxjr", "kybgepdfqtcdbmvaigrfaqcopf", "kqdecwuhjdlxhbfljrniozcfyt", "lcmzdjhltxurvjrskaqmxvwbia", "ksaoeyqehorlcvdudyrcukophv", "nrjfumdfjbdkhpnxmwmsyrxgzo", "xdntkalayzoyhpmsgtjjgytcjs", "okwzzsrlpftqnctkbttrqdvzda", "lmnjyvbzlojqivsxjwjydlzrca", "oungazqhbxggvwzagjnhfwcjcq", "plswuyztihfjzvjvyadrpcxaol", "gsfcqaseawydspnatsmvpgcjhh", "sdjiiffohqnoeznduwkmjgksuq", "vhipgelxcgtogewpdnikjoabal", "kyiioolpypdderrkpjbougjsdo", "qardyvwickoaydezsnchoigsdm", "rtypmvkmoeorwqspijpoflrybj", "cavmlpuqmwlersjqxqyspypezu", "ksgmnvqcyahoosgckjkjnjsjxt", "nkxuhrckidezyddnsehkdmjggc", "ahhwovpllqhmzgzewxfxncilgx", "xqqetgqzuzlsgnxsolbapngtjr", "mnfgauwdefjvspxfyxpmcaopnj", "vbpiupvwgslgsyknsalafaycmd", "myguhbehyrsrhokzccubtdykql", "dddclxtfkuepdcrofabcfffxho", "domxtuekdszxnuirjgwjcwwcss", "purkddgbzpqnqerohgxweupatg", "lqacvlhvwirmvaercocmixvumh", "phsxlhzbldszvnsqsfhcufurtg", "rxegndpxewyapkvhsndeipbkic", "bydbnaqwsperwviwcshrwccugk", "pgvxvtuyxvufmyqlyjwqdbgzgw", "fhxaibwzztwjrlypuqmkojoaok", "djtuicpxpjmgcpdlpdimrebqsm", "hhbmrhdjtvnylqjtjrkxvibtyb", "bprlcokylaoltwqpwarovwzxrj", "xgnychgwhbgvxwknfvelpknxtt", "xgwgsmswjglxkukmglbutvtiyo", "nrdjwrltoahcfejxzbftqrjtdh", "aubgtyypowowvdibwabffqnlwp", "sofnomoytdyhnretlezzznvsos", "naexhxmwrundmhxovlavgazgml", "qavnjytgztsosecighvivxzdum", "eznokueccuspxkrkjkrlpeggrb", "zgrwgtfeaxpyogrekxazmfqjms", "ugmjuychfmczycvoyhizipkffa", "mxoisyjttwlimvjztegpbyqbfe", "oukrvxnpkiwgltcfznwfuevvyf", "yinkomnxqozlahpfoaanujnigj", "ryideoimgshbrtuixitrajxtvk", "wbgmcsxqwwaybprtpuokdnlcjz", "trazfuzllnoqtesfdwpbcuovbs", "zbvvcrxygmiskjsjzwrkowqjdx", "tyztphkstvhxqjdkotrmfxxqgk", "zrsnxlglkxrggehycrkozkzzin", "iibrrnesosagssmohpowjwwfvi", "vtvbqifvqrofxnlrmmlhfcddkq", "uoixkfjnrkdaxmqfjzpzljfcdw", "tdviapusjupeprfpyvyudslvny", "hewqixqbtmltpohzxjgipovjrc", "zvivyepmnrfhlsozsdovfogxgd", "oqtppfgbeslnobcnlpvkjfdiqr", "muxawkqzglmlriuyymhnhqjqbh", "xktmsekwbadafwxlcqsopoorzz", "nppgyvnsvfjmayowrnikouvvey", "mxujsxwzfhhqwvrpthgyjchnqv", "slssracoafigcqndngtpgupxbi", "ajjoelaprobzzkilymmfkkcbxz", "yojzulhpqouvygxgplwptngjex", "srkueffqqnhpsipdfeyamgysef", "rtemniuiyixfrvmpgtnejpaiqo", "xomkywnmopvwiilkjzpzoqbtvb", "lvjqhiyrqgkjsdafotwmnxnltf", "tfttafelwkaybhxcpozveiiwgo", "ubxxttbluazxbcddtpcefammrg", "fsibtkpbaawsedpkmcumvghogd", "neabwpmcwcxfuocuwzbizdkcrq", "rmiucppqrogevnaxmldyukyird", "fqmdwfjodapcqpvsstlyhvozab", "sikbireglslmyrqbxmuuaztmum", "wwmrgjrrgaesfhogvsgwipjcgo", "cvvdpdkneteimuhhhnwuadiysa", "gllzxpplyqxzxdmlyzlqlcxucm", "tgpaszpmsfjkgvrjdbokhdnvgg", "qwxyqtgbzwwxqdvxwngdgcjobf", "ircppbvymohxkwonnrbxnvlubh", "lpetbdcniegltdvnydsdleugom", "pdzoyqfmkwwwhgqvhlyrgztpnp", "tdlccdxmffuasjmjwchwbhbuov", "nweadslhgeiyqldddrknlaonpw", "kqpvpfbguxqwytxwwtqldwzhbd", "mcltnsealsbxfkrowdltljpkbx", "jhqaixcbxtuydeqdomfkwdsmmg", "metvrcygyugwtqacobjvropkra", "utzsbzeaayxswlmvgifsridoqq", "fxffiwgyajkgjsriguwdkaybvk", "oqbcljqdrbpdjrkwagrgkfslpz", "yhinfjhaxuvpwdvmbetvgoynxd", "ssrxaygijzqurlxtpqrncrgnoe", "peapkkjnmmkfrslfdogejbrlto", "dtrzlehwtrnolvnsntuhfwwftq", "ldzyzkhwmhlidxvsmutnvhrduq", "btnmjwiuwftshbvijytsakbdps", "cdcapqdxieirlccuxagcntzzse", "nwpemftjetqgpisiyxuksdjpvy", "arexifxhulwnzypbezlourjzaj", "umbhihwclnmzcstltxnaurtrkr", "qrcenykvepyzgmtisopqllftct", "ermqxantnmrfowhxutghhyqjfv", "xbmrlogwqvvbacopipokaylfue", "epylyncgqubaabtzmfhcehffok", "gnyfatdatqtgemooewtsdmmwao", "nuhkvbjgsozpzoowxkvcjgfjqo", "cnimpiyasgvdxaxwskvdwzonks", "jxejemfyqlvhmgcywkmsdhmwcp", "wzclitbxtawqosptcqqtorwkfc", "evqxuimawmzdygmkoqyajesojt", "zgcrgothqwencndshxkehwmtbe", "sipeaavwhjwnrsjogwtppciaeu", "zahgshcwkhknazjbsnsulfxhsq", "casilbkdkpkojlrymjiwpkckzi", "vkitbpidrxwckfjjnfhctfiqoy", "ybyeqwhuqktantrjacsospkinr", "qvsyzrwplrfhbjcnxczjshtnhl", "cfqnivgmyvykldgbgqejhfsnlz", "jdejdcxyfasuatakrjpahhhyiz", "nceuabhhecubalcbehhqtubghs", "xleujhkzzhfvsvivxapeozrvrd", "bvfmgqdahzfwlqkkfppvgccjvc", "vviamkdievtahmxlvizjvujwhk", "cbkpqifnjhcilkyzqlfdtwygsv", "fcxthgdqgzrxickoctlsqsqlzi", "xzlsamfifxjdlftveeghocvurn", "oldpdqamqzeujbigvoxpufvmgq", "zeqhvjbcaqscaraljlsfiwffrl", "xkuxvndznggdimnldxmfjjumml", "vlkxvzagbqybmnsxrvyomwhjnd", "djsijkprczmhyxlyzhvbgqryuh", "yyfwgcudmknybspsuddxiyjvxj", "eufmmadtoldwxgjieavhtwqtbm", "ipbrbvdixsmorshfrslrqrtelf", "eozjaytdidbysqydgbugfosaxb", "xohxsmyaktzebrqiuzoktenwkg", "uuudjmgpsqcxmhszmemcndvtso", "snciibsnyjjwptmttrmzatssdl", "umnwshhhevmorapbcanozmdmzd", "oojizbmxlsltyyvcblqzmxltii", "zpmdbyqcmxrmpnasahuiivnrcn", "jxbxicjoewpgisgchbawenkueg", "zytpwlxjkxsedkxkvloxhpndft", "nhgypokrxpkhxughjjsireyxuo", "fcntuyjgtwipbaodzevbirgkzp", "caswzaisimrvywujdsepjmxfuk", "nhqknhgqywakblqhqpudgdnnfv", "bqniaukihinfggqskyvcrieviv", "zigzeridjsovkhlsuffuoilwry", "uqdvhofxznpuykatjmvknzkjdu", "lzitgrhjixyyqtgqahmxhbwdzo", "xeqzwsfkuonjxlgugctqpxzkfx", "kxvzxrpbgkifpkjywiegftqgle", "ikxxchfkttbsswpodnsdqvwugw", "puipyyrkflkdqtxgvoxaxhxwbe", "yetvyqvilnzmbjnwoxtqtlouef", "dazwfdmfckuhaaelocvidfulgu"]	[297]	TODO
kkkkkkkkkkkkkkkkkkkkkkkkkkkkkkkkkkkkkkkkkkkkkkkkkkkkkkkkkkkkkkkkkkkkkkkkkkkkkkkkkkkkkkkkkkkkkkkkkkkkkkkkkkkkkkkkkkkkkkkkkkkkkkkkkkkkkkkkkkkkkkkkkkkkkkkkkkkkkkkkkkkkkkkkkkkkkkkkkkkkkkkkkkkkkkkkkkkkkkkkkkkkkkkkkkkkkkkkkkkkkkkkkkkkkkkkkkkkkkkkkkkkkkkkkkkkkkkkkkkkkkkkkkkkkkkkkkkkkkkkkkkkkkkkkkkkkkkkkkkkkkkkkkkkkkkkkkkkkkkkkkkkkkkkkkkkkkkkkkkkkkkkkkkkkkkkkkkkkkkkkkkkkkkkkkkkkkkkkkkkkkkkkkkkkkkkkkkkkkkkkkkkkkkkkkkkkkkkkkkkkkkkkkkkkkkkkkkkkkkkkkkkkkkkkkkkkkkkkkkkkkkkkkkkkkkkkkkkkkkkkkkkkkkkkkkkkkkkkkkkkkkkkkkkkkkkkkkkkkkkkkkkkkkkkkkkkkkkkkkkkkkkkkkkkkkkkkkkkkkkkkkkkkkkkkkkkkkkkkkkkkkkkkkkkkkkkkkkkkkkkkkkkkkkkkkkkkkkkkkkkkkkkkkkkkkkkkkkkkkkkkkkkkkkkkkkkkkkkkkkkkkkkkkkkkkkkkkkkkkkkkkkkkkkkkkkkkkkkkkkkkkkkkkkkkkkkkkkkkkkkkkkkkkkkkkkkkkkkkkkkkkkkkkkkkkkkkkkkkkkkkkkkkkkkkkkkkkkkkkkkkkkkkkkkkkkkkkkkkkkkkkkkkkkkkkkkkkkkkkkkkkkkkkkkkkkkkkkkkkkkkkkkkkkkkkkkkkkkkkkkkkkkkkkkkkkkkkkkkkkkkkkkkkkkkkkkkkkkkkkkkkkkkkkkkkkkkkkkkkkkkkkkkkkkkkkkkkkkkkkkkkkkkkkkkkkkkkkkkkkkkkkkkkkkkkkkkkkkkkkkkkkkkkkkkkkkkkkkkkkkkkkkkkkkkkkkkkkkkkkkkkkkkkkkkkkkkkkkkkkkkkkkkkkkkkkkkkkkkkkkkkkkkkkkkkkkkkkkkkkkkkkkkkkkkkkkkkkkkkkkkkkkkkkkkkkkkkkkkkkkkkkkkkkkkkkkkkkkkkkkkkkkkkkkkkkkkkkkkkkkkkkkkkkkkkkkkkkkkkkkkkkkkkkkkkkkkkkkkkkkkkkkkkkkkkkkkkkkkkkkkkkkkkkkkkkkkkkkkkkkkkkkkkkkkkkkkkkkkkkkkkkkkkkkkkkkkkkkkkkkkkkkkkkkkkkkkkkkkkkkkkkkkkkkkkkkkkkkkkkkkkkkkkkkkkkkkkkkkkkkkkkkkkkkkkkkkkkkkkkkkkkkkkkkkkkkkkkkkkkkkkkkkkkkkkkkkkkkkkkkkkkkkkkkkkkkkkkkkkkkkkkkkkkkkkkkkkkkkkkkkkkkkkkkkkkkkkkkkkkkkkkkkkkkkkkkkkkkkkkkkkkkkkkkkkkkkkkkkkkkkkkkkkkkkkkkkkkkkkkkkkkkkkkkkkkkkkkkkkkkkkkkkkkkkkkkkkkkkkkkkkkkkkkkkkkkkkkkkkkkkkkkkkkkkkkkkkkkkkkkkkkkkkkkkkkkkkkkkkkkkkkkkkkkkkkkkkkkkkkkkkkkkkkkkkkkkkkkkkkkkkkkkkkkkkkkkkkkkkkkkkkkkkkkkkkkkkkkkkkkkkkkkkkkkkkkkkkkkkkkkkkkkkkkkkkkkkkkkkkkkkkkkkkkkkkkkkkkkkkkkkkkkkkkkkkkkkkkkkkkkkkkkkkkkkkkkkkkkkkkkkkkkkkkkkkkkkkkkkkkkkkkkkkkkkkkkkkkkkkkkkkkkkkkkkkkkkkkkkkkkkkkkkkkkkkkkkkkkkkkkkkkkkkkkkkkkkkkkkkkkkkkkkkkkkkkkkkkkkkkkkkkkkkkkkkkkkkkkkkkkkkkkkkkkkkkkkkkkkkkkkkkkkkkkkkkkkkkkkkkkkkkkkkkkkkkkkkkkkkkkkkkkkkkkkkkkkkkkkkkkkkkkkkkkkkkkkkkkkkkkkkkkkkkkkkkkkkkkkkkkkkkkkkkkkkkkkkkkkkkkkkkkkkkkkkkkkkkkkkkkkkkkkkkkkkkkkkkkkkkkkkkkkkkkkkkkkkkkkkkkkkkkkkkkkkkkkkkkkkkkkkkkkkkkkkkkkkkkkkkkkkkkkkkkkkkkkkkkkkkkkkkkkkkkkkkkkkkkkkkkkkkkkkkkkkkkkkkkkkkkkkkkkkkkkkkkkkkkkkkkkkkkkkkkkkkkkkkkkkkkkkkkkkkkkkkkkkkkkkkkkkkkkkkkkkkkkkkkkkkkkkkkkkkkkkkkkkkkkkkkkkkkkkkkkkkkkkkkkkkkkkkkkkkkkkkkkkkkkkkkkkkkkkkkkkkkkkkkkkkkkkkkkkkkkkkkkkkkkkkkkkkkkkkkkkkkkkkkkkkkkkkkkkkkkkkkkkkkkkkkkkkkkkkkkkkkkkkkkkkkkkkkkkkkkkkkkkkkkkkkkkkkkkkkkkkkkkkkkkkkkkkkkkkkkkkkkkkkkkkkkkkkkkkkkkkkkkkkkkkkkkkkkkkkkkkkkkkkkkkkkkkkkkkkkkkkkkkkkkkkkkkkkkkkkkkkkkkkkkkkkkkkkkkkkkkkkkkkkkkkkkkkkkkkkkkkkkkkkkkkkkkkkkkkkkkkkkkkkkkkkkkkkkkkkkkkkkkkkkkkkkkkkkkkkkkkkkkkkkkkkkkkkkkkkkkkkkkkkkkkkkkkkkkkkkkkkkkkkkkkkkkkkkkkkkkkkkkkkkkkkkkkkkkkkkkkkkkkkkkkkkkkkkkkkkkkkkkkkkkkkkkkkkkkkkkkkkkkkkkkkkkkkkkkkkkkkkkkkkkkkkkkkkkkkkkkkkkkkkkkkkkkkkkkkkkkkkkkkkkkkkkkkkkkkkkkkkkkkkkkkkkkkkkkkkkkkkkkkkkkkkkkkkkkkkkkkkkkkkkkkkkkkkkkkkkkkkkkkkkkkkkkkkkkkkkkkkkkkkkkkkkkkkkkkkkkkkkkkkkkkkkkkkkkkkkkkkkkkkkkkkkkkkkkkkkkkkkkkkkkkkkkkkkkkkkkkkkkkkkkkkkkkkkkkkkkkkkkkkkkkkkkkkkkkkkkkkkkkkkkkkkkkkkkkkkkkkkkkkkkkkkkkkkkkkkkkkkkkkkkkkkkkkkkkkkkkkkkkkkkkkkkkkkkkkkkkkkkkkkkkkkkkkkkkkkkkkkkkkkkkkkkkkkkkkkkkkkkkkkkkkkkkkkkkkkkkkkkkkkkkkkkkkkkkkkkkkkkkkkkkkkkkkkkkkkkkkkkkkkkkkkkkkkkkkkkkkkkkkkkkkkkkkkkkkkkkkkkkkkkkkkkkkkkkkkkkkkkkkkkkkkkkkkkkkkkkkkkkkkkkkkkkkkkkkkkkkkkkkkkkkkkkkkkkkkkkkkkkkkkkkkkkkkkkkkkkkkkkkkkkkkkkkkkkkkkkkkkkkkkkkkkkkkkkkkkkkkkkkkkkkkkkkkkkkkkkkkkkkkkkkkkkkkkkkkkkkkkkkkkkkkkkkkkkkkkkkkkkkkkkkkkkkkkkkkkkkkkkkkkkkkkkkkkkkkkkkkkkkkkkkkkkkkkkkkkkkkkkkkkkkkkkkkkkkkkkkkkkkkkkkkkkkkkkkkkkkkkkkkkkkkkkkkkkkkkkkkkkkkkkkkkkkkkkkkkkkkkkkkkkkkkkkkkkkkkkkkkkkkkkkkkkkkkkkkkkkkkkkkkkkkkkkkkkkkkkkkkkkkkkkkkkkkkkkkkkkkkkkkkkkkkkkkkkkkkkkkkkkkkkkkkkkkkkkkkkkkkkkkkkkkkkkkkkkkkkkkkkkkkkkkkkkkkkkkkkkkkkkkkkkkkkkkkkkkkkkkkkkkkkkkkkkkkkkkkkkkkkkkkkkkkkkkkkkkkkkkkkkkkkkkkkkkkkkkkkkkkkkkkkkkkkkkkkkkkkkkkkkkkkkkkkkkkkkkkkkkkkkkkkkkkkkkkkkkkkkkkkkkkkkkkkkkkkkkkkkkkkkkkkkkkkkkkkkkkkkkkkkkkkkkkkkkkkkkkkkkkkkkkkkkkkkkkkkkkkkkkkkkkkkkkkkkkkkkkkkkkkkkkkkkkkkkkkkkkkkkkkkkkkkkkkkkkkkkkkkkkkkkkkkkkkkkkkkkkkkkkkkkkkkkkkkkkkkkkkkkkkkkkkkkkkkkkkkkkkkkkkkkkkkkkkkkkkkkkkkkkkkkkkkkkkkkkkkkkkkkkkkkkkkkkkkkkkkkkkkkkkkkkkkkkkkkkkkkkkkkkkkkkkkkkkkkkkkkkkkkkkkkkkkkkkkkkkkkkkkkkkkkkkkkkkkkkkkkkkkkkkkkkkkkkkkkkkkkkkkkkkkkkkkkkkkkkkkkkkkkkkkkkkkkkkkkkkkkkkkkkkkkkkkkkkkkkkkkkkkkkkkkkkkkkkkkkkkkkkkkkkkkkkkkkkkkkkkkkkkkkkkkkkkkkkkkkkkkkkkkkkkkkkkkkkkkkkkkkkkkkkkkkkkkkkkkkkkkkkkkkkkkkkkkkkkkkkkkkkkkkkkkkkkkkkkkkkkkkkkkkkkkkkkkkkkkkkkkkkkkkkkkkkkkkkkkkkkkkkkkkkkkkkkkkkkkkkkkkkkkkkkkkkkkkkkkkkkkkkkkkkkkkkkkkkkkkkkkkkkkkkkkkkkkkkkkkkkkkkkkkkkkkkkkkkkkkkkkkkkkkkkkkkkkkkkkkkkkkkkkkkkkkkkkkkkkkkkkkkkkkkkkkkkkkkkkkkkkkkkkkkkkkkkkkkkkkkkkkkkkkkkkkkkkkkkkkkkkkkkkkkkkkkkkkkkkkkkkkkkkkkkkkkkkkkkkkkkkkkkkkkkkkkkkkkkkkkkkkkkkkkkkkkkkkkkkkkkkkkkkkkkkkkkkkkkkkkkkkkkkkkkkkkkkkkkkkkkkkkkkkkkkkkkkkkkkkkkkkkkkkkkkkkkkkkkkkkkkkkkkkkkkkkkkkkkkkkkkkkkkkkkkkkkkkkkkkkkkkkkkkkkkkkkkkkkkkkkkkkkkkkk	["k", "k", "k", "k", "k", "k", "k", "k", "k", "k", "k", "k", "k", "k", "k", "k", "k", "k", "k", "k", "k", "k", "k", "k", "k", "k", "k", "k", "k", "k", "k", "k", "k", "k", "k", "k", "k", "k", "k", "k", "k", "k", "k", "k", "k", "k", "k", "k", "k", "k", "k", "k", "k", "k", "k", "k", "k", "k", "k", "k", "k", "k", "k", "k", "k", "k", "k", "k", "k", "k", "k", "k", "k", "k", "k", "k", "k", "k", "k", "k", "k", "k", "k", "k", "k", "k", "k", "k", "k", "k", "k", "k", "k", "k", "k", "k", "k", "k", "k", "k", "k", "k", "k", "k", "k", "k", "k", "k", "k", "k", "k", "k", "k", "k", "k", "k", "k", "k", "k", "k", "k", "k", "k", "k", "k", "k", "k", "k", "k", "k", "k", "k", "k", "k", "k", "k", "k", "k", "k", "k", "k", "k", "k", "k", "k", "k", "k", "k", "k", "k", "k", "k", "k", "k", "k", "k", "k", "k", "k", "k", "k", "k", "k", "k", "k", "k", "k", "k", "k", "k", "k", "k", "k", "k", "k", "k", "k", "k", "k", "k", "k", "k", "k", "k", "k", "k", "k", "k", "k", "k", "k", "k", "k", "k", "k", "k", "k", "k", "k", "k", "k", "k", "k", "k", "k", "k", "k", "k", "k", "k", "k", "k", "k", "k", "k", "k", "k", "k", "k", "k", "k", "k", "k", "k", "k", "k", "k", "k", "k", "k", "k", "k", "k", "k", "k", "k", "k", "k", "k", "k", "k", "k", "k", "k", "k", "k", "k", "k", "k", "k", "k", "k", "k", "k", "k", "k", "k", "k", "k", "k", "k", "k", "k", "k", "k", "k", "k", "k", "k", "k", "k", "k", "k", "k", "k", "k", "k", "k", "k", "k", "k", "k", "k", "k", "k", "k", "k", "k", "k", "k", "k", "k", "k", "k", "k", "k", "k", "k", "k", "k", "k", "k", "k", "k", "k", "k", "k", "k", "k", "k", "k", "k", "k", "k", "k", "k", "k", "k", "k", "k", "k", "k", "k", "k", "k", "k", "k", "k", "k", "k", "k", "k", "k", "k", "k", "k", "k", "k", "k", "k", "k", "k", "k", "k", "k", "k", "k", "k", "k", "k", "k", "k", "k", "k", "k", "k", "k", "k", "k", "k", "k", "k", "k", "k", "k", "k", "k", "k", "k", "k", "k", "k", "k", "k", "k", "k", "k", "k", "k", "k", "k", "k", "k", "k", "k", "k", "k", "k", "k", "k", "k", "k", "k", "k", "k", "k", "k", "k", "k", "k", "k", "k", "k", "k", "k", "k", "k", "k", "k", "k", "k", "k", "k", "k", "k", "k", "k", "k", "k", "k", "k", "k", "k", "k", "k", "k", "k", "k", "k", "k", "k", "k", "k", "k", "k", "k", "k", "k", "k", "k", "k", "k", "k", "k", "k", "k", "k", "k", "k", "k", "k", "k", "k", "k", "k", "k", "k", "k", "k", "k", "k", "k", "k", "k", "k", "k", "k", "k", "k", "k", "k", "k", "k", "k", "k", "k", "k", "k", "k", "k", "k", "k", "k", "k", "k", "k", "k", "k", "k", "k", "k", "k", "k", "k", "k", "k", "k", "k", "k", "k", "k", "k", "k", "k", "k", "k", "k", "k", "k", "k", "k", "k", "k", "k", "k", "k", "k", "k", "k", "k", "k", "k", "k", "k", "k", "k", "k", "k", "k", "k", "k", "k", "k", "k", "k", "k", "k", "k", "k", "k", "k", "k", "k", "k", "k", "k", "k", "k", "k", "k", "k", "k", "k", "k", "k", "k", "k", "k", "k", "k", "k", "k", "k", "k", "k", "k", "k", "k", "k", "k", "k", "k", "k", "k", "k", "k", "k", "k", "k", "k", "k", "k", "k", "k", "k", "k", "k", "k", "k", "k", "k", "k", "k", "k", "k", "k", "k", "k", "k", "k", "k", "k", "k", "k", "k", "k", "k", "k", "k", "k", "k", "k", "k", "k", "k", "k", "k", "k", "k", "k", "k", "k", "k", "k", "k", "k", "k", "k", "k", "k", "k", "k", "k", "k", "k", "k", "k", "k", "k", "k", "k", "k", "k", "k", "k", "k", "k", "k", "k", "k", "k", "k", "k", "k", "k", "k", "k", "k", "k", "k", "k", "k", "k", "k", "k", "k", "k", "k", "k", "k", "k", "k", "k", "k", "k", "k", "k", "k", "k", "k", "k", "k", "k", "k", "k", "k", "k", "k", "k", "k", "k", "k", "k", "k", "k", "k", "k", "k", "k", "k", "k", "k", "k", "k", "k", "k", "k", "k", "k", "k", "k", "k", "k", "k", "k", "k", "k", "k", "k", "k", "k", "k", "k", "k", "k", "k", "k", "k", "k", "k", "k", "k", "k", "k", "k", "k", "k", "k", "k", "k", "k", "k", "k", "k", "k", "k", "k", "k", "k", "k", "k", "k", "k", "k", "k", "k", "k", "k", "k", "k", "k", "k", "k", "k", "k", "k", "k", "k", "k", "k", "k", "k", "k", "k", "k", "k", "k", "k", "k", "k", "k", "k", "k", "k", "k", "k", "k", "k", "k", "k", "k", "k", "k", "k", "k", "k", "k", "k", "k", "k", "k", "k", "k", "k", "k", "k", "k", "k", "k", "k", "k", "k", "k", "k", "k", "k", "k", "k", "k", "k", "k", "k", "k", "k", "k", "k", "k", "k", "k", "k", "k", "k", "k", "k", "k", "k", "k", "k", "k", "k", "k", "k", "k", "k", "k", "k", "k", "k", "k", "k", "k", "k", "k", "k", "k", "k", "k", "k", "k", "k", "k", "k", "k", "k", "k", "k", "k", "k", "k", "k", "k", "k", "k", "k", "k", "k", "k", "k", "k", "k", "k", "k", "k", "k", "k", "k", "k", "k", "k", "k", "k", "k", "k", "k", "k", "k", "k", "k", "k", "k", "k", "k", "k", "k", "k", "k", "k", "k", "k", "k", "k", "k", "k", "k", "k", "k", "k", "k", "k", "k", "k", "k", "k", "k", "k", "k", "k", "k", "k", "k", "k", "k", "k", "k", "k", "k", "k", "k", "k", "k", "k", "k", "k", "k", "k", "k", "k", "k", "k", "k", "k", "k", "k", "k", "k", "k", "k", "k", "k", "k", "k", "k", "k", "k", "k", "k", "k", "k", "k", "k", "k", "k", "k", "k", "k", "k", "k", "k", "k", "k", "k", "k", "k", "k", "k", "k", "k", "k", "k", "k", "k", "k", "k", "k", "k", "k", "k", "k", "k", "k", "k", "k", "k", "k", "k", "k", "k", "k", "k", "k", "k", "k", "k", "k", "k", "k", "k", "k", "k", "k", "k", "k", "k", "k", "k", "k", "k", "k", "k", "k", "k", "k", "k", "k", "k", "k", "k", "k", "k", "k", "k", "k", "k", "k", "k", "k", "k", "k", "k", "k", "k", "k", "k", "k", "k", "k", "k", "k", "k", "k", "k", "k", "k", "k", "k", "k", "k", "k", "k", "k", "k", "k", "k", "k", "k", "k", "k", "k", "k", "k", "k", "k", "k", "k", "k", "k", "k", "k", "k", "k", "k", "k", "k", "k", "k", "k", "k", "k", "k", "k", "k", "k", "k", "k", "k", "k", "k", "k", "k", "k", "k", "k", "k", "k", "k", "k", "k", "k", "k", "k", "k", "k", "k", "k", "k", "k", "k", "k", "k", "k", "k", "k", "k", "k", "k", "k", "k", "k", "k", "k", "k", "k", "k", "k", "k", "k", "k", "k", "k", "k", "k", "k", "k", "k", "k", "k", "k", "k", "k", "k", "k", "k", "k", "k", "k", "k", "k", "k", "k", "k", "k", "k", "k", "k", "k", "k", "k", "k", "k", "k", "k", "k", "k", "k", "k", "k", "k", "k", "k", "k", "k", "k", "k", "k", "k", "k", "k", "k", "k", "k", "k", "k", "k", "k", "k", "k", "k", "k", "k", "k", "k", "k", "k", "k", "k", "k", "k", "k", "k", "k", "k", "k", "k", "k", "k", "k", "k", "k", "k", "k", "k", "k", "k", "k", "k", "k", "k", "k", "k", "k", "k", "k", "k", "k", "k", "k", "k", "k", "k", "k", "k", "k", "k", "k", "k", "k", "k", "k", "k", "k", "k", "k", "k", "k", "k", "k", "k", "k", "k", "k", "k", "k", "k", "k", "k", "k", "k", "k", "k", "k", "k", "k", "k", "k", "k", "k", "k", "k", "k", "k", "k", "k", "k", "k", "k", "k", "k", "k", "k", "k", "k", "k", "k", "k", "k", "k", "k", "k", "k", "k", "k", "k", "k", "k", "k", "k", "k", "k", "k", "k", "k", "k", "k", "k", "k", "k", "k", "k", "k", "k", "k", "k", "k", "k", "k", "k", "k", "k", "k", "k", "k", "k", "k", "k", "k", "k", "k", "k", "k", "k", "k", "k", "k", "k", "k", "k", "k", "k", "k", "k", "k", "k", "k", "k", "k", "k", "k", "k", "k", "k", "k", "k", "k", "k", "k", "k", "k", "k", "k", "k", "k", "k", "k", "k", "k", "k", "k", "k", "k", "k", "k", "k", "k", "k", "k", "k", "k", "k", "k", "k", "k", "k", "k", "k", "k", "k", "k", "k", "k", "k", "k", "k", "k", "k", "k", "k", "k", "k", "k", "k", "k", "k", "k", "k", "k", "k", "k", "k", "k", "k", "k", "k", "k", "k", "k", "k", "k", "k", "k", "k", "k", "k", "k", "k", "k", "k", "k", "k", "k", "k", "k", "k", "k", "k", "k", "k", "k", "k", "k", "k", "k", "k", "k", "k", "k", "k", "k", "k", "k", "k", "k", "k", "k", "k", "k", "k", "k", "k", "k", "k", "k", "k", "k", "k", "k", "k", "k", "k", "k", "k", "k", "k", "k", "k", "k", "k", "k", "k", "k", "k", "k", "k", "k", "k", "k", "k", "k", "k", "k", "k", "k", "k", "k", "k", "k", "k", "k", "k", "k", "k", "k", "k", "k", "k", "k", "k", "k", "k", "k", "k", "k", "k", "k", "k", "k", "k", "k", "k", "k", "k", "k", "k", "k", "k", "k", "k", "k", "k", "k", "k", "k", "k", "k", "k", "k", "k", "k", "k", "k", "k", "k", "k", "k", "k", "k", "k", "k", "k", "k", "k", "k", "k", "k", "k", "k", "k", "k", "k", "k", "k", "k", "k", "k", "k", "k", "k", "k", "k", "k", "k", "k", "k", "k", "k", "k", "k", "k", "k", "k", "k", "k", "k", "k", "k", "k", "k", "k", "k", "k", "k", "k", "k", "k", "k", "k", "k", "k", "k", "k", "k", "k", "k", "k", "k", "k", "k", "k", "k", "k", "k", "k", "k", "k", "k", "k", "k", "k", "k", "k", "k", "k", "k", "k", "k", "k", "k", "k", "k", "k", "k", "k", "k", "k", "k", "k", "k", "k", "k", "k", "k", "k", "k", "k", "k", "k", "k", "k", "k", "k", "k", "k", "k", "k", "k", "k", "k", "k", "k", "k", "k", "k", "k", "k", "k", "k", "k", "k", "k", "k", "k", "k", "k", "k", "k", "k", "k", "k", "k", "k", "k", "k", "k", "k", "k", "k", "k", "k", "k", "k", "k", "k", "k", "k", "k", "k", "k", "k", "k", "k", "k", "k", "k", "k", "k", "k", "k", "k", "k", "k", "k", "k", "k", "k", "k", "k", "k", "k", "k", "k", "k", "k", "k", "k", "k", "k", "k", "k", "k", "k", "k", "k", "k", "k", "k", "k", "k", "k", "k", "k", "k", "k", "k", "k", "k", "k", "k", "k", "k", "k", "k", "k", "k", "k", "k", "k", "k", "k", "k", "k", "k", "k", "k", "k", "k", "k", "k", "k", "k", "k", "k", "k", "k", "k", "k", "k", "k", "k", "k", "k", "k", "k", "k", "k", "k", "k", "k", "k", "k", "k", "k", "k", "k", "k", "k", "k", "k", "k", "k", "k", "k", "k", "k", "k", "k", "k", "k", "k", "k", "k", "k", "k", "k", "k", "k", "k", "k", "k", "k", "k", "k", "k", "k", "k", "k", "k", "k", "k", "k", "k", "k", "k", "k", "k", "k", "k", "k", "k", "k", "k", "k", "k", "k", "k", "k", "k", "k", "k", "k", "k", "k", "k", "k", "k", "k", "k", "k", "k", "k", "k", "k", "k", "k", "k", "k", "k", "k", "k", "k", "k", "k", "k", "k", "k", "k", "k", "k", "k", "k", "k", "k", "k", "k", "k", "k", "k", "k", "k", "k", "k", "k", "k", "k", "k", "k", "k", "k", "k", "k", "k", "k", "k", "k", "k", "k", "k", "k", "k", "k", "k", "k", "k", "k", "k", "k", "k", "k", "k", "k", "k", "k", "k", "k", "k", "k", "k", "k", "k", "k", "k", "k", "k", "k", "k", "k", "k", "k", "k", "k", "k", "k", "k", "k", "k", "k", "k", "k", "k", "k", "k", "k", "k", "k", "k", "k", "k", "k", "k", "k", "k", "k", "k", "k", "k", "k", "k", "k", "k", "k", "k", "k", "k", "k", "k", "k", "k", "k", "k", "k", "k", "k", "k", "k", "k", "k", "k", "k", "k", "k", "k", "k", "k", "k", "k", "k", "k", "k", "k", "k", "k", "k", "k", "k", "k", "k", "k", "k", "k", "k", "k", "k", "k", "k", "k", "k", "k", "k", "k", "k", "k", "k", "k", "k", "k", "k", "k", "k", "k", "k", "k", "k", "k", "k", "k", "k", "k", "k", "k", "k", "k", "k", "k", "k", "k", "k", "k", "k", "k", "k", "k", "k", "k", "k", "k", "k", "k", "k", "k", "k", "k", "k", "k", "k", "k", "k", "k", "k", "k", "k", "k", "k", "k", "k", "k", "k", "k", "k", "k", "k", "k", "k", "k", "k", "k", "k", "k", "k", "k", "k", "k", "k", "k", "k", "k", "k", "k", "k", "k", "k", "k", "k", "k", "k", "k", "k", "k", "k", "k", "k", "k", "k", "k", "k", "k", "k", "k", "k", "k", "k", "k", "k", "k", "k", "k", "k", "k", "k", "k", "k", "k", "k", "k", "k", "k", "k", "k", "k", "k", "k", "k", "k", "k", "k", "k", "k", "k", "k", "k", "k", "k", "k", "k", "k", "k", "k", "k", "k", "k", "k", "k", "k", "k", "k", "k", "k", "k", "k", "k", "k", "k", "k", "k", "k", "k", "k", "k", "k", "k", "k", "k", "k", "k", "k", "k", "k", "k", "k", "k", "k", "k", "k", "k", "k", "k", "k", "k", "k", "k", "k", "k", "k", "k", "k", "k", "k", "k", "k", "k", "k", "k", "k", "k", "k", "k", "k", "k", "k", "k", "k", "k", "k", "k", "k", "k", "k", "k", "k", "k", "k", "k", "k", "k", "k", "k", "k", "k", "k", "k", "k", "k", "k", "k", "k", "k", "k", "k", "k", "k", "k", "k", "k", "k", "k", "k", "k", "k", "k", "k", "k", "k", "k", "k", "k", "k", "k", "k", "k", "k", "k", "k", "k", "k", "k", "k", "k", "k", "k", "k", "k", "k", "k", "k", "k", "k", "k", "k", "k", "k", "k", "k", "k", "k", "k", "k", "k", "k", "k", "k", "k", "k", "k", "k", "k", "k", "k", "k", "k", "k", "k", "k", "k", "k", "k", "k", "k", "k", "k", "k", "k", "k", "k", "k", "k", "k", "k", "k", "k", "k", "k", "k", "k", "k", "k", "k", "k", "k", "k", "k", "k", "k", "k", "k", "k", "k", "k", "k", "k", "k", "k", "k", "k", "k", "k", "k", "k", "k", "k", "k", "k", "k", "k", "k", "k", "k", "k", "k", "k", "k", "k", "k", "k", "k", "k", "k", "k", "k", "k", "k", "k", "k", "k", "k", "k", "k", "k", "k", "k", "k", "k", "k", "k", "k", "k", "k", "k", "k", "k", "k", "k", "k", "k", "k", "k", "k", "k", "k", "k", "k", "k", "k", "k", "k", "k", "k", "k", "k", "k", "k", "k", "k", "k", "k", "k", "k", "k", "k", "k", "k", "k", "k", "k", "k", "k", "k", "k", "k", "k", "k", "k", "k", "k", "k", "k", "k", "k", "k", "k", "k", "k", "k", "k", "k", "k", "k", "k", "k", "k", "k", "k", "k", "k", "k", "k", "k", "k", "k", "k", "k", "k", "k", "k", "k", "k", "k", "k", "k", "k", "k", "k", "k", "k", "k", "k", "k", "k", "k", "k", "k", "k", "k", "k", "k", "k", "k", "k", "k", "k", "k", "k", "k", "k", "k", "k", "k", "k", "k", "k", "k", "k", "k", "k", "k", "k", "k", "k", "k", "k", "k", "k", "k", "k", "k", "k", "k", "k", "k", "k", "k", "k", "k", "k", "k", "k", "k", "k", "k", "k", "k", "k", "k", "k", "k", "k", "k", "k", "k", "k", "k", "k", "k", "k", "k", "k", "k", "k", "k", "k", "k", "k", "k", "k", "k", "k", "k", "k", "k", "k", "k", "k", "k", "k", "k", "k", "k", "k", "k", "k", "k", "k", "k", "k", "k", "k", "k", "k", "k", "k", "k", "k", "k", "k", "k", "k", "k", "k", "k", "k", "k", "k", "k", "k", "k", "k", "k", "k", "k", "k", "k", "k", "k", "k", "k", "k", "k", "k", "k", "k", "k", "k", "k", "k", "k", "k", "k", "k", "k", "k", "k", "k", "k", "k", "k", "k", "k", "k", "k", "k", "k", "k", "k", "k", "k", "k", "k", "k", "k", "k", "k", "k", "k", "k", "k", "k", "k", "k", "k", "k", "k", "k", "k", "k", "k", "k", "k", "k", "k", "k", "k", "k", "k", "k", "k", "k", "k", "k", "k", "k", "k", "k", "k", "k", "k", "k", "k", "k", "k", "k", "k", "k", "k", "k", "k", "k", "k", "k", "k", "k", "k", "k", "k", "k", "k", "k", "k", "k", "k", "k", "k", "k", "k", "k", "k", "k", "k", "k", "k", "k", "k", "k", "k", "k", "k", "k", "k", "k", "k", "k", "k", "k", "k", "k", "k", "k", "k", "k", "k", "k", "k", "k", "k", "k", "k", "k", "k", "k", "k", "k", "k", "k", "k", "k", "k", "k", "k", "k", "k", "k", "k", "k", "k", "k", "k", "k", "k", "k", "k", "k", "k", "k", "k", "k", "k", "k", "k", "k", "k", "k", "k", "k", "k", "k", "k", "k", "k", "k", "k", "k", "k", "k", "k", "k", "k", "k", "k", "k", "k", "k", "k", "k", "k", "k", "k", "k", "k", "k", "k", "k", "k", "k", "k", "k", "k", "k", "k", "k", "k", "k", "k", "k", "k", "k", "k", "k", "k", "k", "k", "k", "k", "k", "k", "k", "k", "k", "k", "k", "k", "k", "k", "k", "k", "k", "k", "k", "k", "k", "k", "k", "k", "k", "k", "k", "k", "k", "k", "k", "k", "k", "k", "k", "k", "k", "k", "k", "k", "k", "k", "k", "k", "k", "k", "k", "k", "k", "k", "k", "k", "k", "k", "k", "k", "k", "k", "k", "k", "k", "k", "k", "k", "k", "k", "k", "k", "k", "k", "k", "k", "k", "k", "k", "k", "k", "k", "k", "k", "k", "k", "k", "k", "k", "k", "k", "k", "k", "k", "k", "k", "k", "k", "k", "k", "k", "k", "k", "k", "k", "k", "k", "k", "k", "k", "k", "k", "k", "k", "k", "k", "k", "k", "k", "k", "k", "k", "k", "k", "k", "k", "k", "k", "k", "k", "k", "k", "k", "k", "k", "k", "k", "k", "k", "k", "k", "k", "k", "k", "k", "k", "k", "k", "k", "k", "k", "k", "k", "k", "k", "k", "k", "k", "k", "k", "k", "k", "k", "k", "k", "k", "k", "k", "k", "k", "k", "k", "k", "k", "k", "k", "k", "k", "k", "k", "k", "k", "k", "k", "k", "k", "k", "k", "k", "k", "k", "k", "k", "k", "k", "k", "k", "k", "k", "k", "k", "k", "k", "k", "k", "k", "k", "k", "k", "k", "k", "k", "k", "k", "k", "k", "k", "k", "k", "k", "k", "k", "k", "k", "k", "k", "k", "k", "k", "k", "k", "k", "k", "k", "k", "k", "k", "k", "k", "k", "k", "k", "k", "k", "k", "k", "k", "k", "k", "k", "k", "k", "k", "k", "k", "k", "k", "k", "k", "k", "k", "k", "k", "k", "k", "k", "k", "k", "k", "k", "k", "k", "k", "k", "k", "k", "k", "k", "k", "k", "k", "k", "k", "k", "k", "k", "k", "k", "k", "k", "k", "k", "k", "k", "k", "k", "k", "k", "k", "k", "k", "k", "k", "k", "k", "k", "k", "k", "k", "k", "k", "k", "k", "k", "k", "k", "k", "k", "k", "k", "k", "k", "k", "k", "k", "k", "k", "k", "k", "k", "k", "k", "k", "k", "k", "k", "k", "k", "k", "k", "k", "k", "k", "k", "k", "k", "k", "k", "k", "k", "k", "k", "k", "k", "k", "k", "k", "k", "k", "k", "k", "k", "k", "k", "k", "k", "k", "k", "k", "k", "k", "k", "k", "k", "k", "k", "k", "k", "k", "k", "k", "k", "k", "k", "k", "k", "k", "k", "k", "k", "k", "k", "k", "k", "k", "k", "k", "k", "k", "k", "k", "k", "k", "k", "k", "k", "k", "k", "k", "k", "k", "k", "k", "k", "k", "k", "k", "k", "k", "k", "k", "k", "k", "k", "k", "k", "k", "k", "k", "k", "k", "k", "k", "k", "k", "k", "k", "k", "k", "k", "k", "k", "k", "k", "k", "k", "k", "k", "k", "k", "k", "k", "k", "k", "k", "k", "k", "k", "k", "k", "k", "k", "k", "k", "k", "k", "k", "k", "k", "k", "k", "k", "k", "k", "k", "k", "k", "k", "k", "k", "k", "k", "k", "k", "k", "k", "k", "k", "k", "k", "k", "k", "k", "k", "k", "k", "k", "k", "k", "k", "k", "k", "k", "k", "k", "k", "k", "k", "k", "k", "k", "k", "k", "k", "k", "k", "k", "k", "k", "k", "k", "k", "k", "k", "k", "k", "k", "k", "k", "k", "k", "k", "k", "k", "k", "k", "k", "k", "k", "k", "k", "k", "k", "k", "k", "k", "k", "k", "k", "k", "k", "k", "k", "k", "k", "k", "k", "k", "k", "k", "k", "k", "k", "k", "k", "k", "k", "k", "k", "k", "k", "k", "k", "k", "k", "k", "k", "k", "k", "k", "k", "k", "k", "k", "k", "k", "k", "k", "k", "k", "k", "k", "k", "k", "k", "k", "k", "k", "k", "k", "k", "k", "k", "k", "k", "k", "k", "k", "k", "k", "k", "k", "k", "k", "k", "k", "k", "k", "k", "k", "k", "k", "k", "k", "k", "k", "k", "k", "k", "k", "k", "k", "k", "k", "k", "k", "k", "k", "k", "k", "k", "k", "k", "k", "k", "k", "k", "k", "k", "k", "k", "k", "k", "k", "k", "k", "k", "k", "k", "k", "k", "k", "k", "k", "k", "k", "k", "k", "k", "k", "k", "k", "k", "k", "k", "k", "k", "k", "k", "k", "k", "k", "k", "k", "k", "k", "k", "k", "k", "k", "k", "k", "k", "k", "k", "k", "k", "k", "k", "k", "k", "k", "k", "k", "k", "k", "k", "k", "k", "k", "k", "k", "k", "k", "k", "k", "k", "k", "k", "k", "k", "k", "k", "k", "k", "k", "k", "k", "k", "k", "k", "k", "k", "k", "k", "k", "k", "k", "k", "k", "k", "k", "k", "k", "k", "k", "k", "k", "k", "k", "k", "k", "k", "k", "k", "k", "k", "k", "k", "k", "k", "k", "k", "k", "k", "k", "k", "k", "k", "k", "k", "k", "k", "k", "k", "k", "k", "k", "k", "k", "k", "k", "k", "k", "k", "k", "k", "k", "k", "k", "k", "k", "k", "k", "k", "k", "k", "k", "k", "k", "k", "k", "k", "k", "k", "k", "k", "k", "k", "k", "k", "k", "k", "k", "k", "k", "k", "k", "k", "k", "k", "k", "k", "k", "k", "k", "k", "k", "k", "k", "k", "k", "k", "k", "k", "k", "k", "k", "k", "k", "k", "k", "k", "k", "k", "k", "k", "k", "k", "k", "k", "k", "k", "k", "k", "k", "k", "k", "k", "k", "k", "k", "k", "k", "k", "k", "k", "k", "k", "k", "k", "k", "k", "k", "k", "k", "k", "k", "k", "k", "k", "k", "k", "k", "k", "k", "k", "k", "k", "k", "k", "k", "k", "k", "k", "k", "k", "k", "k", "k", "k", "k", "k", "k", "k", "k", "k", "k", "k", "k", "k", "k", "k", "k", "k", "k", "k", "k", "k", "k", "k", "k", "k", "k", "k", "k", "k", "k", "k", "k", "k", "k", "k", "k", "k", "k", "k", "k", "k", "k", "k", "k", "k", "k", "k", "k", "k", "k", "k", "k", "k", "k", "k", "k", "k", "k", "k", "k", "k", "k", "k", "k", "k", "k", "k", "k", "k", "k", "k", "k", "k", "k", "k", "k", "k", "k", "k", "k", "k", "k", "k", "k", "k", "k", "k", "k", "k", "k", "k", "k", "k", "k", "k", "k", "k", "k", "k", "k", "k", "k", "k", "k", "k", "k", "k", "k", "k", "k", "k", "k", "k", "k", "k", "k", "k", "k", "k", "k", "k", "k", "k", "k", "k", "k", "k", "k", "k", "k", "k", "k", "k", "k", "k", "k", "k", "k", "k", "k", "k", "k", "k", "k", "k", "k", "k", "k", "k", "k", "k", "k", "k", "k", "k", "k", "k", "k", "k", "k", "k", "k", "k", "k", "k", "k", "k", "k", "k", "k", "k", "k", "k", "k", "k", "k", "k", "k", "k", "k", "k", "k", "k", "k", "k", "k", "k", "k", "k", "k", "k", "k", "k", "k", "k", "k", "k", "k", "k", "k", "k", "k", "k", "k", "k", "k", "k", "k", "k", "k", "k", "k", "k", "k", "k", "k", "k", "k", "k", "k", "k", "k", "k", "k", "k", "k", "k", "k", "k", "k", "k", "k", "k", "k", "k", "k", "k", "k", "k", "k", "k", "k", "k", "k", "k", "k", "k", "k", "k", "k", "k", "k", "k", "k", "k", "k", "k", "k", "k", "k", "k", "k", "k", "k", "k", "k", "k", "k", "k", "k", "k", "k", "k", "k", "k", "k", "k", "k", "k", "k", "k", "k", "k", "k", "k", "k", "k", "k", "k", "k", "k", "k", "k", "k", "k", "k", "k", "k", "k", "k", "k", "k", "k", "k", "k", "k", "k", "k", "k", "k", "k", "k", "k", "k", "k", "k", "k", "k", "k", "k", "k", "k", "k", "k", "k", "k", "k", "k", "k", "k", "k", "k", "k", "k", "k", "k", "k", "k", "k", "k", "k", "k", "k", "k", "k", "k", "k", "k", "k", "k", "k", "k", "k", "k", "k", "k", "k", "k", "k", "k", "k", "k", "k", "k", "k", "k", "k", "k", "k", "k", "k", "k", "k", "k", "k", "k", "k", "k", "k", "k", "k", "k", "k", "k", "k", "k", "k", "k", "k", "k", "k", "k", "k", "k", "k", "k", "k", "k", "k", "k", "k", "k", "k", "k", "k", "k", "k", "k", "k", "k", "k", "k", "k", "k", "k", "k", "k", "k", "k", "k", "k", "k", "k", "k", "k", "k", "k", "k", "k", "k", "k", "k", "k", "k", "k", "k", "k", "k", "k", "k", "k", "k", "k", "k", "k", "k", "k", "k", "k", "k", "k", "k", "k", "k", "k", "k", "k", "k", "k", "k", "k", "k", "k", "k", "k", "k", "k", "k", "k", "k", "k", "k", "k", "k", "k", "k", "k", "k", "k", "k", "k", "k", "k", "k", "k", "k", "k", "k", "k", "k", "k", "k", "k", "k", "k", "k", "k", "k", "k", "k", "k", "k", "k", "k", "k", "k", "k", "k", "k", "k", "k", "k", "k", "k", "k", "k", "k", "k", "k", "k", "k", "k", "k", "k", "k", "k", "k", "k", "k", "k", "k", "k", "k", "k", "k", "k", "k", "k", "k", "k", "k", "k", "k", "k", "k", "k", "k", "k", "k", "k", "k", "k", "k", "k", "k", "k", "k", "k", "k", "k", "k", "k", "k", "k", "k", "k", "k", "k", "k", "k", "k", "k", "k", "k", "k", "k", "k", "k", "k", "k", "k", "k", "k", "k", "k", "k", "k", "k", "k", "k", "k", "k", "k", "k", "k", "k", "k", "k", "k", "k", "k", "k", "k", "k", "k", "k", "k", "k", "k", "k", "k", "k", "k", "k", "k", "k", "k", "k", "k", "k", "k", "k", "k", "k", "k", "k", "k", "k", "k", "k", "k", "k", "k", "k", "k", "k", "k", "k", "k", "k", "k", "k", "k", "k", "k", "k", "k", "k", "k", "k", "k", "k", "k", "k", "k", "k", "k", "k", "k", "k", "k", "k", "k", "k", "k", "k", "k", "k", "k", "k", "k", "k", "k", "k", "k", "k", "k", "k", "k", "k", "k", "k", "k", "k", "k", "k", "k", "k", "k", "k", "k", "k", "k", "k", "k", "k", "k", "k", "k", "k", "k", "k", "k", "k", "k", "k", "k", "k", "k", "k", "k", "k", "k", "k", "k", "k", "k", "k", "k", "k", "k", "k", "k", "k", "k", "k", "k", "k", "k", "k", "k", "k", "k", "k", "k", "k", "k", "k", "k", "k", "k", "k", "k", "k", "k", "k", "k", "k", "k", "k", "k", "k", "k", "k", "k", "k", "k", "k", "k", "k", "k", "k", "k", "k", "k", "k", "k", "k", "k", "k", "k", "k", "k", "k", "k", "k", "k", "k", "k", "k", "k", "k", "k", "k", "k", "k", "k", "k", "k", "k", "k", "k", "k", "k", "k", "k", "k", "k", "k", "k", "k", "k", "k", "k", "k", "k", "k", "k", "k", "k", "k", "k", "k", "k", "k", "k", "k", "k", "k", "k", "k", "k", "k", "k", "k", "k", "k", "k", "k", "k", "k", "k", "k", "k", "k", "k", "k", "k", "k", "k", "k", "k", "k", "k", "k", "k", "k", "k", "k", "k", "k", "k", "k", "k", "k", "k", "k", "k", "k", "k", "k", "k", "k", "k", "k", "k", "k", "k", "k", "k", "k", "k", "k", "k", "k", "k", "k", "k", "k", "k", "k", "k", "k", "k", "k", "k", "k", "k", "k", "k", "k", "k", "k", "k", "k", "k", "k", "k", "k", "k", "k", "k", "k", "k", "k", "k", "k", "k", "k", "k", "k", "k", "k", "k", "k", "k", "k", "k", "k", "k", "k", "k", "k", "k", "k", "k", "k", "k", "k", "k", "k", "k", "k", "k", "k", "k", "k", "k", "k", "k", "k", "k", "k", "k", "k", "k", "k", "k", "k", "k", "k", "k", "k", "k", "k", "k", "k", "k", "k", "k", "k", "k", "k", "k", "k", "k", "k", "k", "k", "k", "k", "k", "k", "k", "k", "k", "k", "k", "k", "k", "k", "k", "k", "k", "k", "k", "k", "k", "k", "k", "k", "k", "k", "k", "k", "k", "k", "k", "k", "k", "k", "k", "k", "k", "k", "k", "k", "k", "k", "k", "k", "k", "k", "k", "k", "k", "k", "k", "k", "k", "k", "k", "k", "k", "k", "k", "k", "k", "k", "k", "k", "k", "k", "k", "k", "k", "k", "k", "k", "k", "k", "k", "k", "k", "k", "k", "k", "k", "k", "k", "k", "k", "k", "k", "k", "k", "k", "k", "k", "k", "k", "k", "k", "k", "k", "k", "k", "k", "k", "k", "k", "k", "k", "k", "k", "k", "k", "k", "k", "k", "k", "k", "k", "k", "k", "k", "k", "k", "k", "k", "k", "k", "k", "k", "k", "k", "k", "k", "k", "k", "k", "k", "k", "k", "k", "k", "k", "k", "k", "k", "k", "k", "k", "k", "k", "k", "k", "k", "k", "k", "k", "k", "k", "k", "k", "k", "k", "k", "k", "k", "k", "k", "k", "k", "k", "k", "k", "k", "k", "k", "k", "k", "k", "k", "k", "k", "k", "k", "k", "k", "k", "k", "k", "k", "k", "k", "k", "k", "k", "k", "k", "k", "k", "k", "k", "k", "k", "k", "k", "k", "k", "k", "k", "k", "k", "k", "k", "k", "k", "k", "k", "k", "k", "k", "k", "k", "k", "k", "k", "k", "k", "k", "k", "k", "k", "k", "k", "k", "k", "k", "k", "k", "k", "k", "k", "k", "k", "k", "k", "k", "k", "k", "k", "k", "k", "k", "k", "k", "k", "k", "k", "k", "k", "k", "k", "k", "k", "k", "k", "k", "k", "k", "k", "k", "k", "k", "k", "k", "k", "k", "k", "k", "k", "k", "k", "k", "k", "k", "k", "k", "k", "k", "k", "k", "k", "k", "k", "k", "k", "k", "k", "k", "k", "k"]	[]	TODO
bobobobobobobobobobobobobobobobobobobobobobobobobobobobobobobobobobobobobobobobobobobobobobobobobobobobobobobobobobobobobobobobobobobobobobobobobobobobobobobobobobobobobobobobobobobobobobobobobobobobobobobobobobobobobobobobobobobobobobobobobobobobobobobobobobobobobobobobobobobobobobobobobobobobobobobobobobobobobobobobobobobobobobobobobobobobobobobobobobobobobobobobobobobobobobobobobobobobobobobobobobobobobobobobobobobobobobobobobobobobobobobobobobobobobobobobobobobobobobobobobobobobobobobobobobobobobobobobobobobobobobobobobobobobobobobobobobobobobobobobobobobobobobobobobobobobobobobobobobobobobobobobobobobobobobobobobobobobobobobobobobobobobobobobobobobobobobobobobobobobobobobobobobobobobobobobobobobobobobobobobobobobobobobobobobobobobobobobobobobobobobobobobobobobobobobobobobobobobobobobobobobobobobobobobobobobobobobobobobobobobobobobobobobobobobobobobobobobobobobobobobobobobobobobobobobobobobobobobobobobobobobobobobobobobobobobobobobobobobobobobobobobobobobobobobobobobobobobobobobobobobobobobobobobobobobobobobobobobobobobobobobobobobobobobobobobobobobobobobobobobobobobobobobobobobobobobobobobobobobobobobobobobobobobobobobobobobobobobobobobobobobobobobobobobobobobobobobobobobobobobobobobobobobobobobobobobobobobobobobobobobobobobobobobobobobobobobobobobobobobobobobobobobobobobobobobobobobobobobobobobobobobobobobobobobobobobobobobobobobobobobobobobobobobobobobobobobobobobobobobobobobobobobobobobobobobobobobobobobobobobobobobobobobobobobobobobobobobobobobobobobobobobobobobobobobobobobobobobobobobobobobobobobobobobobobobobobobobobobobobobobobobobobobobobobobobobobobobobobobobobobobobobobobobobobobobobobobobobobobobobobobobobobobobobobobobobobobobobobobobobobobobobobobobobobobobobobobobobobobobobobobobobobobobobobobobobobobobobobobobobobobobobobobobobobobobobobobobobobobobobobobobobobobobobobobobobobobobobobobobobobobobobobobobobobobobobobobobobobobobobobobobobobobobobobobobobobobobobobobobobobobobobobobobobobobobobobobobobobobobobobobobobobobobobobobobobobobobobobobobobobobobobobobobobobobobobobobobobobobobobobobobobobobobobobobobobobobobobobobobobobobobobobobobobobobobobobobobobobobobobobobobobobobobobobobobobobobobobobobobobobobobobobobobobobobobobobobobobobobobobobobobobobobobobobobobobobobobobobobobobobobobobobobobobobobobobobobobobobobobobobobobobobobobobobobobobobobobobobobobobobobobobobobobobobobobobobobobobobobobobobobobobobobobobobobobobobobobobobobobobobobobobobobobobobobobobobobobobobobobobobobobobobobobobobobobobobobobobobobobobobobobobobobobobobobobobobobobobobobobobobobobobobobobobobobobobobobobobobobobobobobobobobobobobobobobobobobobobobobobobobobobobobobobobobobobobobobobobobobobobobobobobobobobobobobobobobobobobobobobobobobobobobobobobobobobobobobobobobobobobobobobobobobobobobobobobobobobobobobobobobobobobobobobobobobobobobobobobobobobobobobobobobobobobobobobobobobobobobobobobobobobobobobobobobobobobobobobobobobobobobobobobobobobobobobobobobobobobobobobobobobobobobobobobobobobobobobobobobobobobobobobobobobobobobobobobobobobobobobobobobobobobobobobobobobobobobobobobobobobobobobobobobobobobobobobobobobobobobobobobobobobobobobobobobobobobobobobobobobobobobobobobobobobobobobobobobobobobobobobobobobobobobobobobobobobobobobobobobobobobobobobobobobobobobobobobobobobobobobobobobobobobobobobobobobobobobobobobobobobobobobobobobobobobobobobobobobobobobobobobobobobobobobobobobobobobobobobobobobobobobobobobobobobobobobobobobobobobobobobobobobobobobobobobobobobobobobobobobobobobobobobobobobobobobobobobobobobobobobobobobobobobobobobobobobobobobobobobobobobobobobobobobobobobobobobobobobobobobobobobobobobobobobobobobobobobobobobobobobobobobobobobobobobobobobobobobobobobobobobobobobobobobobobobobobobobobobobobobobobobobobobobobobobobobobobobobobobobobobobobobobobobobobobobobobobobobobobobobobobobobobobobobobobobobobobobobobobobobobobobobobobobobobobobobobobobobobobobobobobobobobobobobobobobobobobobobobobobobobobobobobobobobobobobobobobobobobobobobobobobobobobobobobobobobobobobobobobobobobobobobobobobobobobobobobobobobobobobobobobobobobobobobobobobobobobobobobobobobobobobobobobobobobobobobobobobobobobobobobobobobobobobobobobobobobobobobobobobobobobobobobobobobobobobobobobobobobobobobobobobobobobobobobobobobobobobobobobobobobobobobobobobobobobobobobobobobobobobobobobobobobobobobobobobobobobobobobobobobobobobobobobobobobobobobobobobobobobobobobobobobobobobobobobobobobobobobobobobobobobobobobobobobobobobobobobobobobobobobobobobobobobobobobobobobobobobobobobobobobobobobobobobobobobobobobobobobobobobobobobobobobobobobobobobobobobobobobobobobobobobobobobobobobobobobobobobobobobobobobobobobobobobobobobobobobobobobobobobobobobobobobobobobobobobobobobobobobobobobobobobobobobobobobobobobobobobobobobobobobobobobobobobobobobobobobobobobobobobobobobobobobobobobobobobobobobobobobobobobobobobobobobobobobobobobobobobobobobobobobobobobobobobobobobobobobobobobobobobobobobobobobobobobobobobobobobobobobobobobobobobobobobobobobobobobobobobobobobobobobobobobobobobobobobobobobobobobobobobobobobobobobobobobobobobobobobobobobobobobobobobobobobobobobobobobobobobobobobobobobobobobobobobobobobobobobobobobobobobobobobobobobobobobobobobobobobobobobobobobobobobobobobobobobobobobobobobobobobobobobobobobobobobobobobobobobobobobobobobobobobobobobobobobobobobobobobobobobobobobobobobobobobobobobobobobobobobobobobobobobobobobobobobobobobobobobobobobobobobobobobobobobobobobobobobobobobobobobobobobobobobobobobobobobobobobobobobobobobobobobobobobobobobobobobobobobobobobobobobobobobobobobobobobobobobobobobobobobobobobobobobobobobobobobobobobobobobobobobobobobobobobobobobobobobobobobobobobobobobobobobobobobobobobobobobobobobobobobobobobobobobobobobobobobobobobobobobobobobobobobobobobobobobobobobobobobobobobobobobobobobobobobobobobobobobobobobobobobobobobobobobobobobobobobobobobobobobobobobobobobobobobobobobobobobobobobobobobobobobobobobobobobobobobobobobobobobobobobobobobobobobobobobobobobobobobobobobobobobobobobobobobobobobobobobobobobobobobobobobobobobobobobobobobobobobobobobobobobobobobobobobobobobobobobobobobobobobobobobobobobobobobobobobobobobobobobobobobobobobobobobobobobobobobobobobobobobobobobobobobobobobobobobobobobobobobobobobobobobobobobobobobobobobobobobobobobobobobobobobobobobobobobobobobobobobobobobobobobobobobobobobobobobobobobobobobobobobobobobobobobobobobobobobobobobobobobobobobobobobobobobobobobobobobobobobobobobobobobobobobobobobobobobobobobobobobobobobobobobobobobobobobobobobobobobobobobobobobobobobobobobobobobobobobobobobobobobobobobobobobobobobobobobobobobobobobobobobobobobobobobobobobobobobobobobobobobobobobobobobobobobobobobobobobobobobobobobobobobobobobobobobobobobobobobobobobobobobobobobobobobobobobobobobobobobobobobobobobobobobobobobobobobobobobobobobobobobobobobobobobobobobobobobobobobobobobobobobobobobobobobobobobobobobobobobobobobobobobobobobobobobobobobobobobobobobobobobobobobobobobobobobobobobobobobobobobobobobobobobobobobobobobobobobobobobobobobobobobobobobobobobobobobobobobobobobobobobobobobobobobobobobobobobobobobobobobobobobobobobobobobobobobobobobobobobobobobobobobobobobobobobobobobobobobobobobobobobobobobobobobobobobobobobobobobobobobobobobobobobobobobobobobobobobobobobobobobobobobobobobobobobobobobobobobobobobobobobobobobobobobobobobobobobobobobobobobobobobobobobobobobobobobobobobobobobobobobobobobobobobobobobobobobobobobobobobobobobobobobobobobobobobobobobobobobobobobobobobobobobobobobobobobobobobobobobobobobobobobobobobobobobobobobobobobobobobobobobobobobobobobobobobobobobobobobobobobobobobobobobobobobobobobobobobobobobobobobobobobobobobobobobobobobobobobobobobobobobobobobobobobobobobobobobobobobobobobobobobobobobobobobobobobobobobobobobobobobobobobobobobobobobobobobobobobobobobobobobobobobobobobobobobobobobobobobobobobobobobobobobobobobobobobobobobobobobobobobobobobobobobobobobobobobobobobobobobobobobobobobobobobobobobobobobobobobobobobobobobobobobobobobobobobobobobobobobobobobobobobobobobobobobobobobobobobobobobobobobobobobobobobobobobobobobobobobobobobobobobobobobobobobobobobobobobobobobobobobobobobobobobobobobobobobobobobobobobobobobobobobobobobobobobobobobobobobobobobobobobobobobobobobobobobobobobobobobobobobobobobobobobobobobobobobobobobobobobobobobobobobobobobobobobobobobobobobobobobobobobobobobobobobobobobobobobobobobobobobobobobobobobobobobobobobobobobobobobobobobobobobobobobobobobobobobobobobobobobobobobobobobobobobobobobobobobobobobobobobobobobobobobobobobobobobobobobobobobobobobobobobobobobobobobobobobobobobobobobobobobobobobobobobobobobobobobobobobobobobobobobobobobobobobobobobobobobobobobobobobobobobobobobobobobobobobobobobobobobobobobobobobobobobobobobobobobobobobobobobobobobobobobobobobobobobobobobobobobobobobobobobobobobobobobobobobobobobobobobobobobobobobobobobobobobobobobobobobobobobobobobobobobobobobobobobobobobobobobobobobobobobobobobobobobobobobobobobobobobobobobobobobobobobobobobobobobobobobobobobobobobobobobobobobobobobobobobobobobobobobobobobobobobobobobobobobobobobobobobobobobobobobobobobobobobobobobobobobobobobobobobobobobobobobobobobobobobobobobobobobobobobobobobobobobobobobobobobobobobobobobobobobobobobobobobobobobobobobobobobobobobobobobobobobobobobobobobobobobobobobobobobobobobobobobobobobobobobobobobobobobobobobobobobobobobobobobobobobobobobobobobobobobobobobobobobobobobobobobobobobobobobobobobobobobobobobobobobobobobobobobobobobobobobobobobobobobobobobobobobobobobobobobobobobobobobobobobobobobobobobobobobobobobobobobobobobobobobobobobobobobobobobobobobobobobobobobobobobobobobobobobobobobobobobobobobobobobobobobobobobobobobobobobobobobobobobobobobobobobobobobobobobobobobobobobobobobobobobobobobobobobobobobobobobobobobobobobobobobobobobobobobobobobobobobobobobobobobobobobobobobobobobobobobobobobobobobobobobobobobobobobobobobobobobobobobobobobobobobobobobobobobobobobobobobobobobobobobobobobobobobobobobobobobobobobobobobobobobobobobobobobobobobobobobobobobobobobobobobobobobobobobobobobobobobobobobobobobobobobobobobobobobobobobobobobobobobobobobobobobobobobobobobobobobobobobobobobobobobobobobobobobobobobobobobobobobobobobobobobobobobobobobobobobobobobobobobobobobobobobobobobobobobobobobo	["bo", "ob", "bo", "ob", "bo", "ob", "bo", "ob", "bo", "ob", "bo", "ob", "bo", "ob", "bo", "ob", "bo", "ob", "bo", "ob", "bo", "ob", "bo", "ob", "bo", "ob", "bo", "ob", "bo", "ob", "bo", "ob", "bo", "ob", "bo", "ob", "bo", "ob", "bo", "ob", "bo", "ob", "bo", "ob", "bo", "ob", "bo", "ob", "bo", "ob", "bo", "ob", "bo", "ob", "bo", "ob", "bo", "ob", "bo", "ob", "bo", "ob", "bo", "ob", "bo", "ob", "bo", "ob", "bo", "ob", "bo", "ob", "bo", "ob", "bo", "ob", "bo", "ob", "bo", "ob", "bo", "ob", "bo", "ob", "bo", "ob", "bo", "ob", "bo", "ob", "bo", "ob", "bo", "ob", "bo", "ob", "bo", "ob", "bo", "ob", "bo", "ob", "bo", "ob", "bo", "ob", "bo", "ob", "bo", "ob", "bo", "ob", "bo", "ob", "bo", "ob", "bo", "ob", "bo", "ob", "bo", "ob", "bo", "ob", "bo", "ob", "bo", "ob", "bo", "ob", "bo", "ob", "bo", "ob", "bo", "ob", "bo", "ob", "bo", "ob", "bo", "ob", "bo", "ob", "bo", "ob", "bo", "ob", "bo", "ob", "bo", "ob", "bo", "ob", "bo", "ob", "bo", "ob", "bo", "ob", "bo", "ob", "bo", "ob", "bo", "ob", "bo", "ob", "bo", "ob", "bo", "ob", "bo", "ob", "bo", "ob", "bo", "ob", "bo", "ob", "bo", "ob", "bo", "ob", "bo", "ob", "bo", "ob", "bo", "ob", "bo", "ob", "bo", "ob", "bo", "ob", "bo", "ob", "bo", "ob"]	[]	TODO
